,player,games,points_played,off_possessions,scores,assists,goals,blocks,plus_minus,completions,completion_pct,total_yards,throwing_yards,receiving_yards,off_efficiency,hockey_assists,throwaways,stalls,drops,callahans,pulls,off_points_played,def_points_played,minutes_played,position
0,Cameron Brock,122,2631,2838,756,240,516,49,585,1644,89.45,1856,702,1154,50.46,146,177,0,43,0,6,2204,427,2123,Cutter
1,Cameron Harris,108,2361,2734,610,337,273,115,488,2035,89.61,4651,2674,1977,50.51,180,198,1,39,0,132,1756,605,2117,Hybrid
2,Ben Jagt,79,1995,2194,525,254,271,115,485,1231,89.85,7135,1760,5375,50.55,121,122,2,33,1,114,1202,793,2000,Hybrid
3,Jonathan Helton,110,2550,2288,609,362,247,147,458,2312,89.58,4712,2680,2032,50.35,152,255,3,43,0,452,1738,812,1886,Hybrid
4,Keenan Plew,115,2429,2656,644,358,286,32,456,3584,94.97,0,0,0,49.96,213,179,1,41,1,5,2076,353,2022,Hybrid
5,Rick Gross,93,2114,2430,427,161,266,131,444,1290,92.41,4058,2035,2023,47.78,130,84,3,30,0,3,1331,783,2120,Hybrid
6,Matt Smith,92,1917,2119,450,147,303,50,415,1762,96.02,4138,1412,2726,56.82,187,59,2,26,1,1,1545,372,1763,Hybrid
7,Travis Carpenter,115,2679,2704,461,279,182,141,411,2705,92.96,5088,3438,1650,47.6,196,173,2,18,0,576,1585,1094,2356,Hybrid
8,Peter Graffy,78,1916,1858,328,175,153,168,386,1159,89.57,1021,531,490,47.36,123,101,4,9,0,1041,475,1441,1998,Defender
9,Mischa Freystaetter,60,1532,1678,400,149,251,58,376,1048,93.82,0,0,0,53.58,140,52,1,30,0,1,1014,518,1472,Hybrid
10,Jay Froude,70,1585,1823,329,147,182,116,350,863,89.62,2004,661,1343,47.23,96,80,1,15,2,80,814,771,1573,Hybrid
11,Andrew Meshnick,108,2506,2141,315,164,151,172,344,887,86.12,1112,656,456,46.33,99,118,0,25,0,52,497,2009,2337,Defender
12,Isaiah Masek-Kelly,96,2100,2313,426,233,193,119,338,1729,89.96,118,168,-50,49.37,179,154,0,53,0,218,1329,771,1846,Hybrid
13,Mike Drost,114,2289,1731,235,94,141,181,337,933,92.28,783,-54,837,42.35,99,74,1,5,2,1,437,1852,2111,Defender
14,Beau Kittredge,80,1904,2154,332,128,204,109,337,1640,94.2,0,0,0,51.02,168,88,1,16,1,21,1200,704,1838,Cutter
15,Sean McDougall,77,1638,1761,331,132,199,95,336,814,91.98,4056,1201,2855,48.44,93,64,0,26,1,2,998,640,1590,Cutter
16,Matt Stevens,115,1802,2075,342,49,293,31,333,812,95.53,1887,347,1540,52.0,78,30,2,10,0,0,1593,209,1544,Cutter
17,Travis Dunn,76,1855,2024,398,219,179,50,324,1579,92.34,5235,2014,3221,49.65,175,112,2,12,0,1,1202,653,1820,Cutter
18,Ryan Drost,101,2149,1905,216,72,144,171,313,857,92.35,734,34,700,41.94,87,69,2,5,0,1,410,1739,2305,Defender
19,Marcelo Sanchez,87,2283,2734,384,203,181,76,308,1512,91.03,1262,623,639,51.32,180,130,4,22,0,6,1642,641,2113,Hybrid
20,Kevin Pettit-Scantling,110,2000,1560,232,99,133,153,308,738,90.44,1996,751,1245,45.83,64,59,0,18,0,214,332,1668,1816,Defender
21,Rowan McDonnell,65,1592,1703,353,198,155,67,295,1853,92.7,3483,2353,1130,49.32,143,113,2,12,1,269,891,701,1598,Hybrid
22,Pat Shriwise,100,1748,1881,364,207,157,72,292,2366,94.04,2598,1208,1390,51.73,146,116,6,28,0,2,1339,409,1569,Hybrid
23,Jeff Babbitt,67,1528,1274,187,28,159,127,285,544,95.44,1751,196,1555,45.45,51,22,0,7,0,15,453,1075,1566,Defender
24,Sean Ham,64,1455,1783,306,59,247,25,285,838,95.55,0,0,0,53.62,86,36,0,10,0,1,1188,267,1357,Cutter
25,Max Sheppard,69,1598,1853,403,210,193,48,281,1225,88.13,4934,1804,3130,48.25,75,145,3,25,0,269,1060,538,1574,Cutter
26,Jeff Lindquist,92,1807,1953,369,245,124,61,280,1496,90.94,0,0,0,50.59,159,126,0,24,0,81,1050,757,1566,Handler
27,Mark Burton,51,1281,1632,416,282,134,15,276,1529,90.1,2469,1502,967,49.2,106,143,1,12,0,0,1135,146,1217,Handler
28,Mark Lloyd,50,1073,956,268,121,147,89,273,881,90.45,0,0,0,49.58,66,77,0,7,0,258,510,563,860,Hybrid
29,Jacob Fairfax,65,1430,1644,259,88,171,57,273,765,95.63,4304,1729,2575,53.53,72,29,4,14,0,26,1093,337,1377,Cutter
30,Brian Schoenrock,59,1281,1206,218,78,140,110,270,579,92.94,0,0,0,37.31,63,36,1,22,0,1,425,856,1129,
31,Justin Allen,83,1825,1932,336,178,158,77,265,972,86.25,255,84,171,47.77,95,130,0,18,1,438,846,979,1830,Cutter
32,AJ Nelson,48,1064,944,273,70,203,53,261,1107,94.37,0,0,0,41.95,55,49,1,16,0,1,736,328,737,
33,Alec Arsenault,60,1312,1567,285,88,197,65,256,672,88.19,2355,649,1706,44.74,84,68,2,26,0,0,921,391,1223,Cutter
34,Levi Jacobs,81,1606,1861,346,188,158,50,255,929,86.9,4898,1886,3012,49.81,104,123,2,18,0,45,1050,556,1651,Hybrid
35,Andrew Carroll,76,1535,1818,298,150,148,53,246,1115,91.92,2893,1079,1814,50.88,141,81,5,24,1,9,937,598,1499,Cutter
36,Mark Fedorenko,75,1553,1526,274,119,155,82,246,1186,91.8,0,0,0,47.18,90,85,4,25,1,280,844,709,1292,Hybrid
37,Dave Wiseman,94,1673,1705,373,201,172,66,245,1159,86.43,0,0,0,49.15,78,161,1,33,0,217,1206,467,1350,Cutter
38,Sean Mott,71,1701,2216,383,236,147,54,244,1887,90.9,5302,2986,2316,42.96,147,160,0,33,0,28,1381,320,1830,Cutter
39,Steve Armitage,59,1025,1051,250,58,192,45,244,377,91.73,0,0,0,52.05,39,29,0,22,0,4,672,353,761,
40,Jack Williams,56,1437,1709,308,173,135,35,244,1878,94.94,6489,4069,2420,56.88,188,84,1,15,0,8,1140,297,1454,Hybrid
41,Terrence Mitchell,87,1744,2130,298,96,202,35,237,1077,92.92,2953,648,2305,55.63,125,67,2,29,0,2,1433,311,1697,Cutter
42,Jesse Cohen,71,1384,1751,310,141,169,33,231,1197,91.44,1500,280,1220,52.88,121,94,0,18,1,0,1222,162,1348,
43,Anson Reppermund,76,1512,1349,153,66,87,145,231,489,87.17,1346,455,891,40.55,50,58,1,9,1,142,385,1127,1452,Defender
44,Colin Camp,67,1091,1467,283,105,178,30,230,909,93.04,0,0,0,52.97,76,49,1,34,0,5,945,146,1169,Cutter
45,Steven Milardovich,75,1784,1549,204,122,82,134,228,1077,90.35,1894,1161,733,45.06,100,98,2,12,0,258,610,1174,1803,Defender
46,Greg Cohen,57,1252,1192,222,89,133,75,228,392,85.78,162,101,61,41.44,44,59,0,10,0,331,366,886,1239,Defender
47,Pawel Janas,54,1390,1725,363,322,41,23,226,3058,93.8,7290,4940,2350,50.09,180,142,2,18,0,108,1156,234,1458,Handler
48,Quentin Bonnaud,37,824,1064,230,60,170,37,223,546,93.02,0,0,0,46.8,68,31,0,13,0,0,684,140,812,Cutter
49,Tyler DeGirolamo,29,746,911,247,143,104,31,221,697,93.18,0,0,0,54.12,76,41,0,16,0,2,563,183,670,
50,Jonathan Martin,44,915,889,195,79,116,69,218,306,87.93,0,0,0,48.03,31,36,1,10,0,164,216,699,846,Defender
51,Karl Loiseau,57,1268,1637,278,142,136,40,217,1090,91.91,0,0,0,46.92,108,81,1,20,0,4,975,293,1229,Hybrid
52,Ryan Osgar,39,916,1192,268,165,103,21,214,930,93.28,7363,3084,4279,53.69,84,61,0,14,0,0,843,73,906,Hybrid
53,Kevin Quinlan,101,2125,2547,471,312,159,63,212,1900,86.84,3395,1811,1584,41.89,123,270,5,52,0,95,1693,432,1907,Hybrid
54,Zach Theodore,69,1371,1105,165,48,117,86,211,347,91.32,0,0,0,40.9,34,27,0,13,0,0,327,1044,1223,Cutter
55,Mark Elbogen,55,1169,1482,291,122,169,29,211,853,88.95,0,0,0,50.4,80,91,0,18,0,4,1020,149,1119,
56,Eric Hubbard,54,1282,1377,177,36,141,77,211,526,93.1,0,0,0,27.31,44,23,0,20,0,10,623,659,1177,
57,Scott Richgels,57,1071,1017,220,102,118,56,210,675,92.72,0,0,0,49.85,49,43,6,23,1,1,717,354,817,Cutter
58,Brandon Fein,81,1604,1470,167,43,124,88,201,484,91.49,277,76,201,37.89,34,40,0,14,1,459,529,1075,1510,Defender
59,Geoff Powell,65,1215,1039,186,60,126,78,200,590,91.33,209,38,171,46.78,52,51,0,13,0,3,404,811,1004,Defender
60,Jeff Wodatch,54,1195,1535,257,114,143,29,199,987,92.07,1864,721,1143,52.25,121,67,0,20,0,0,1010,185,1199,Cutter
61,Paul Lally,63,1442,1603,267,137,130,41,197,1332,92.12,3316,2224,1092,47.04,120,99,0,12,0,173,954,488,1430,Hybrid
62,Dylan DeClerck,61,1120,973,117,27,90,99,197,268,95.71,1276,174,1102,40.6,29,11,0,8,0,5,185,935,1097,Defender
63,Jonathan Nethercutt,44,1180,1436,285,238,47,33,196,1946,92.76,1369,1097,272,52.3,145,117,2,5,1,70,889,291,1127,Handler
64,Kurt Gibson,48,1216,1334,274,167,107,33,195,1628,93.35,1425,984,441,50.82,129,96,7,16,0,146,698,518,1225,Hybrid
65,Ethan Beardsley,60,1395,1794,185,18,167,47,193,413,95.38,0,0,0,47.49,61,13,0,26,0,1,1071,324,1307,Cutter
66,Noah Saul,71,1779,1853,273,194,79,69,192,2219,92.54,1447,1307,140,48.68,149,141,2,9,1,380,858,921,1815,Handler
67,Thomas Slack,61,1235,1590,212,71,141,32,191,820,94.91,2037,354,1683,55.22,72,36,0,17,0,0,1029,206,1260,Cutter
68,James Kittlesen,75,1357,1186,109,34,75,130,191,308,88.76,775,194,581,36.34,27,34,0,14,1,0,247,1110,1278,Defender
69,Michael Pardo,49,1097,1401,229,57,172,52,190,672,90.2,585,162,423,45.4,76,59,1,32,0,3,875,222,1150,Cutter
70,Eli Kerns,52,1278,1525,296,186,110,35,188,1483,90.65,0,0,0,47.21,118,130,7,13,0,154,816,462,1240,
71,Nathan Vickroy,42,1030,1207,247,138,109,36,186,778,88.91,0,0,0,51.28,66,87,2,10,0,36,781,249,1010,Cutter
72,Antoine Davis,56,1416,1614,242,105,137,59,184,743,87.0,4206,1284,2922,50.25,82,90,0,27,1,2,1011,405,1369,
73,Dalton Smith,52,1154,1297,232,120,112,40,183,1399,93.89,793,763,30,50.27,94,80,3,9,0,48,617,537,1149,Hybrid
74,Matt Kerrigan,48,939,1265,202,104,98,28,183,873,95.51,0,0,0,50.04,70,35,2,12,0,0,834,105,924,Cutter
75,Taylor Brooks,69,1245,1408,262,162,100,36,182,978,89.64,0,0,0,46.45,58,109,2,7,0,16,1067,178,1029,
76,Matt Bode,55,1210,1375,204,97,107,43,181,1016,94.07,903,374,529,51.93,96,55,2,11,0,19,817,393,1148,Cutter
77,Simon Higgins,32,801,989,204,80,124,27,179,454,89.55,0,0,0,52.48,60,44,0,8,0,23,589,212,749,
78,Bryan Vohnoutka,48,978,1181,217,92,125,33,179,652,90.68,3399,958,2441,50.55,70,59,0,12,0,25,714,264,1001,Cutter
79,Conor Kline,56,915,1003,210,50,160,12,179,335,90.54,1309,210,1099,52.14,29,30,0,13,0,10,652,263,905,Cutter
80,Lior Givol,54,1182,1275,209,82,127,38,178,748,91.44,3350,1294,2056,50.04,87,63,1,6,1,2,750,432,1160,Cutter
81,Thomson McKnight,110,2296,2662,324,233,91,49,178,3753,94.15,1499,1023,476,50.94,254,177,0,18,0,120,1853,443,1972,Handler
82,Eric Lissner,59,1305,1543,263,173,90,46,176,1344,90.51,0,0,0,49.0,99,115,4,18,0,63,979,326,1310,
83,Brian Hart,55,1000,1107,197,92,105,50,174,1016,93.47,0,0,0,50.05,85,58,5,15,0,9,530,470,993,
84,Jimmy Mickle,41,1214,1494,261,171,90,43,173,1232,89.53,0,0,0,50.74,122,119,7,12,0,200,872,342,1180,
85,Brad Houser,48,1138,1415,226,98,128,25,173,791,91.87,2601,1034,1567,47.84,61,58,1,20,0,1,909,229,1109,Cutter
86,Adrian Yearwood,80,1545,1831,257,168,89,33,172,1915,94.2,0,0,0,51.83,148,102,3,16,1,1,1136,409,1349,Handler
87,Jeffrey Silverman,91,1558,1176,109,52,57,95,169,497,93.25,334,140,194,43.54,59,28,2,7,0,0,224,1334,1497,
88,David Vatz,52,1131,1497,202,24,178,11,168,532,94.49,0,0,0,52.24,46,27,0,18,0,0,985,146,1087,Cutter
89,Ross Barker,47,1054,1135,226,98,128,23,167,894,91.6,4403,1376,3027,53.39,85,63,0,19,0,72,748,306,1060,Cutter
90,Andrew Roney,48,1334,1450,276,209,67,58,165,2127,91.68,3715,2598,1117,47.38,122,160,1,9,0,22,852,482,1362,Hybrid
91,Sterling Knoche,44,945,730,107,22,85,78,165,195,92.42,1504,247,1257,44.79,15,11,0,9,0,0,145,800,976,Defender
92,Thomas Coolidge,89,1462,1456,167,72,95,65,163,1053,94.78,0,0,0,51.58,101,47,2,22,1,0,785,677,1295,Hybrid
93,Lucas Dallmann,48,1024,1104,211,119,92,50,163,664,86.57,0,0,0,44.47,48,88,0,10,1,98,437,587,981,
94,James Hron,23,525,360,149,55,94,37,163,338,95.21,0,0,0,48.33,15,14,1,9,0,3,388,137,294,
95,Christian Olsen,57,1220,1231,215,118,97,33,161,1097,92.89,885,522,363,52.07,104,75,0,12,0,9,698,522,1242,Cutter
96,David Richardson,77,1259,875,69,14,55,116,161,157,90.23,473,111,362,39.89,22,14,0,10,0,1,118,1141,1217,Cutter
97,Ben Ivers,63,1013,690,117,20,97,66,160,286,94.7,0,0,0,42.32,23,15,0,8,0,0,102,911,792,
98,Seth Meyer,54,788,711,106,31,75,74,159,161,89.94,0,0,0,40.93,17,11,2,10,1,0,93,695,810,Defender
99,Abe Coffin,45,975,1204,213,129,84,17,158,1082,93.68,3398,1937,1461,51.83,75,63,0,9,0,36,764,211,983,Hybrid
100,Jacky Hau,87,1437,1260,122,54,68,98,157,476,88.64,730,284,446,42.62,50,52,1,11,0,96,194,1243,1408,Defender
101,Carson Wilder,48,882,1082,177,74,103,28,156,474,89.77,1078,124,954,47.13,44,43,0,6,0,5,625,257,875,Hybrid
102,Keegan North,49,1006,1199,215,121,94,32,153,898,90.98,2328,1250,1078,49.87,86,74,1,20,0,26,755,251,1019,
103,Jackson Stearns,49,1264,1484,238,94,144,31,152,770,87.4,617,195,422,49.33,103,96,2,21,0,8,984,280,1176,Cutter
104,Corey Hardesty,51,1126,1304,170,41,129,35,151,372,88.15,949,257,692,36.58,49,43,0,11,0,0,717,409,1043,
105,Tyler Bacon,68,1407,1452,222,127,95,43,151,1101,90.17,0,0,0,46.76,95,105,2,9,0,190,650,757,1392,
106,Bradley Seuntjens,65,1382,1183,110,19,91,62,150,476,95.58,761,86,675,40.07,49,17,1,5,0,2,478,904,1353,Defender
107,Bryan Nguyen,43,846,1047,174,44,130,17,150,410,91.52,0,0,0,50.91,48,33,1,8,0,0,749,97,809,Cutter
108,Michael Kiyoi,77,1372,1443,187,80,107,36,149,973,94.01,2621,1272,1349,50.17,108,57,0,17,0,0,764,608,1392,Hybrid
109,Nathan Hirst,52,1000,1318,200,103,97,26,148,990,92.96,3979,2668,1311,52.5,98,62,4,16,1,3,871,129,964,
110,Cassidy Rasmussen,49,1227,1479,230,133,97,34,148,1258,90.44,0,0,0,50.37,126,106,3,10,0,101,810,417,1154,
111,Matt Weber,64,971,679,110,17,93,56,147,125,92.59,0,0,0,41.38,16,10,0,9,0,1,186,785,705,Defender
112,Brandon Matis,88,1423,1214,138,54,84,78,147,398,87.47,573,9,564,38.47,28,49,0,20,0,232,279,1144,1305,Defender
113,Steven Chang,71,1669,2115,239,138,101,19,146,2461,95.31,2198,1572,626,49.83,154,99,1,13,0,4,1451,218,1621,Handler
114,Matthew Rehder,26,695,818,142,54,88,47,146,373,88.6,0,0,0,51.59,40,36,1,7,0,73,499,196,668,Hybrid
115,Cole Sullivan,38,979,1246,261,181,80,21,146,1439,90.79,0,0,0,52.25,113,121,0,15,0,19,830,149,983,Handler
116,Andrew Walch,49,1099,1342,149,50,99,35,146,747,96.02,0,0,0,46.05,77,25,0,13,1,0,775,324,1064,
117,Bobby Ley,50,1334,1640,274,200,74,33,145,2550,93.44,4816,3276,1540,52.44,138,153,2,9,0,9,1139,195,1396,Handler
118,Tom Radcliffe,34,853,1132,187,98,89,30,145,673,91.19,0,0,0,43.55,58,54,1,18,0,2,738,115,796,
119,Nick Hutton,83,1484,1264,132,97,35,119,144,449,81.05,971,718,253,36.79,49,89,0,18,0,912,205,1279,1515,Defender
120,Dominic Leggio,69,1644,1708,161,100,61,56,143,2325,96.39,1281,1055,226,48.77,159,59,2,15,1,19,904,740,1714,Handler
121,Hunter Corbett,47,988,993,153,77,76,46,143,728,92.04,1936,697,1239,47.03,64,48,2,8,0,14,509,479,939,Hybrid
122,Chris Mazur,49,1065,1112,240,176,64,30,143,1389,91.74,1520,1158,362,52.79,75,117,2,10,0,162,762,303,892,
123,Brent George,45,964,1216,168,42,126,20,142,802,95.7,0,0,0,54.28,92,32,1,14,0,0,888,76,910,
124,Elijah Jaime,33,671,802,151,30,121,17,142,322,93.6,2811,325,2486,56.11,38,17,0,9,0,2,579,92,700,
125,Jordan Huston,33,730,913,157,28,129,11,142,490,95.33,0,0,0,51.48,40,19,1,7,0,0,604,126,780,Cutter
126,Iain Mackenzie,63,1113,942,119,51,68,65,142,419,91.89,1353,704,649,44.59,49,30,0,12,0,29,188,925,1096,Defender
127,Matthew Crawford,65,1252,1125,163,91,72,43,142,835,92.88,984,701,283,45.24,68,57,1,7,0,86,494,758,1132,Defender
128,Donnie Clark,32,743,786,153,45,108,31,142,185,84.86,0,0,0,48.98,25,27,1,15,0,6,389,354,665,
129,Mike Pannone,60,857,573,102,30,72,79,142,273,93.81,0,0,0,47.47,21,26,0,13,0,0,119,738,678,Defender
130,Allan Laviolette,57,1185,1218,198,121,77,32,140,963,91.11,4847,2131,2716,53.78,94,80,0,10,0,242,716,469,1179,Handler
131,Greg Martin,40,819,830,139,30,109,29,140,323,93.9,3466,331,3135,42.17,33,19,0,9,0,246,414,405,804,Cutter
132,Yoland Cabot,51,1090,1366,216,113,103,32,139,727,87.07,0,0,0,42.02,43,88,1,21,0,52,728,362,1049,Cutter
133,Kevin Brown,63,1162,1243,214,130,84,47,139,1109,88.86,0,0,0,48.59,84,111,5,11,1,389,618,544,1134,Handler
134,Jimmy Towle,47,1009,1247,169,59,110,37,138,600,92.02,4291,1582,2709,48.68,70,47,1,21,0,0,822,187,1046,
135,Jeremy Hill,48,1027,1245,166,53,113,44,137,478,87.87,2866,1012,1854,43.94,67,56,3,17,0,6,751,276,1038,
136,André Arsenault,57,1056,999,119,38,81,72,137,304,86.86,703,241,462,35.54,40,42,0,12,0,7,303,753,1031,Defender
137,Edward Guo,41,818,955,155,66,89,24,135,457,92.32,0,0,0,48.8,71,31,0,13,0,0,570,248,754,
138,Ben Lewis,61,969,827,98,15,83,63,135,221,91.7,1876,121,1755,39.06,27,20,0,6,0,1,163,806,905,Defender
139,Chuck Cantone,54,851,845,118,32,86,42,135,349,95.1,0,0,0,46.86,37,17,2,8,1,40,347,504,796,
140,Kai Marshall,55,1148,1423,166,68,98,55,134,570,88.24,534,279,255,50.88,65,64,3,23,0,16,833,315,1104,Cutter
141,Nate Thibedeau,47,651,606,155,62,93,22,134,469,92.5,0,0,0,51.82,28,33,1,10,0,0,521,130,443,
142,Benjamin Burelle,35,672,760,157,65,92,24,134,311,87.11,0,0,0,51.58,45,37,0,10,0,0,477,195,572,Cutter
143,Kelvin Williams,62,1066,724,71,10,61,75,134,151,94.97,436,145,291,38.95,17,7,0,5,0,0,192,874,1050,Defender
144,Shane Sisco,50,972,977,147,43,104,29,134,413,91.57,268,77,191,44.32,40,32,0,10,0,0,438,534,989,Cutter
145,Jay Drescher,46,914,813,140,87,53,95,133,454,80.21,0,0,0,38.87,35,94,1,8,0,554,279,635,780,
146,Ben Katz,49,1137,1156,162,93,69,40,130,1276,93.96,3072,2512,560,50.69,87,68,0,4,0,11,607,530,1226,Hybrid
147,Ethan Pollack,38,803,1059,161,63,98,22,130,567,92.65,0,0,0,45.61,52,38,0,15,1,3,639,164,799,Cutter
148,Marques Brownlee,64,1253,789,175,88,87,58,130,482,83.97,1005,530,475,44.99,28,86,2,17,0,613,458,795,989,Cutter
149,Nate Goff,41,806,694,101,48,53,60,129,354,93.65,1499,511,988,45.68,29,20,1,12,0,93,214,592,843,Defender
150,Greg Cousins,34,733,967,166,72,94,45,129,494,86.06,0,0,0,41.16,45,68,0,14,0,49,484,249,724,Cutter
151,Ethan Falat,50,968,884,136,68,68,54,127,620,91.31,0,0,0,43.89,49,51,1,12,0,4,371,597,878,Defender
152,Wes Groth,48,742,799,140,65,75,35,127,335,86.79,984,354,630,51.56,39,41,1,7,0,1,422,320,696,
153,Jeff Nordgren,53,956,838,116,40,76,56,126,329,88.68,0,0,0,39.38,33,37,2,9,0,3,286,670,949,Cutter
154,Derek Fenton,23,562,637,162,84,78,10,126,247,86.36,0,0,0,48.04,26,34,1,12,0,24,363,199,448,
155,Mike Arcata,47,976,1163,200,115,85,25,126,748,88.1,4002,2077,1925,45.83,57,88,1,11,0,45,742,234,1015,Cutter
156,Antoine Genest,66,1501,1655,248,173,75,61,125,1086,84.78,0,0,0,36.98,77,164,2,20,0,222,640,861,1466,Handler
157,Tom Annen,82,1418,1355,214,143,71,33,125,2194,94.53,643,551,92,50.7,105,105,3,17,0,3,1095,323,1124,Handler
158,Daniel Emmons,59,880,781,78,33,45,74,125,188,88.26,189,-5,194,38.03,25,21,0,6,0,116,100,780,874,Defender
159,Danny Miller,65,1061,1425,189,73,116,18,125,662,90.44,885,271,614,46.46,49,60,0,22,0,2,888,173,1140,Cutter
160,Kyle Henke,38,826,989,175,74,101,22,125,525,88.83,3394,1056,2338,47.02,51,59,1,13,0,17,621,205,848,
161,Khalif El-Salaam,31,840,705,138,87,51,34,124,484,91.49,1492,780,712,44.11,42,39,0,9,0,262,278,562,814,Cutter
162,Nick Boucher,65,1602,1651,210,149,61,88,124,1281,86.85,2736,1927,809,39.79,93,157,2,17,0,555,680,922,1530,Handler
163,Justin Norden,60,1478,1736,273,217,56,19,124,2451,92.7,4616,3464,1152,49.25,177,160,2,8,0,7,1116,362,1418,Handler
164,Matt Jackson,57,1203,1368,156,88,68,37,124,1388,94.94,1618,1955,-337,49.49,92,63,1,6,0,16,661,542,1180,Hybrid
165,Austin Taylor,58,1331,1495,202,145,57,9,123,1465,93.91,6375,4687,1688,55.59,112,70,1,18,0,12,1044,287,1304,Cutter
166,Matt Esser,53,1082,637,135,68,67,68,123,581,88.16,488,295,193,34.38,28,66,0,14,0,214,360,722,721,Defender
167,Isaiah Bryant,54,918,564,151,108,43,58,121,925,91.4,0,0,0,39.54,38,81,2,7,0,33,195,723,644,
168,Liam Shramko,48,783,675,118,48,70,39,119,447,94.11,0,0,0,43.26,24,25,0,13,1,10,520,263,513,
169,Spencer Loscar,76,1249,1189,120,50,70,58,119,411,89.54,0,0,0,40.71,56,38,0,21,0,41,410,839,1199,
170,Mick Walter,47,859,751,71,20,51,68,118,291,94.79,1489,913,576,38.35,31,15,0,6,2,7,275,584,826,
171,Darren Wu,40,861,1036,142,35,107,30,118,352,88.66,0,0,0,50.77,63,38,1,16,0,11,641,220,724,Cutter
172,Kevin Seiler,26,519,305,135,91,44,21,118,568,94.2,0,0,0,51.8,25,25,0,13,0,9,442,77,228,
173,Josh Klane,62,1363,1644,287,224,63,26,118,2465,91.47,3280,2471,809,49.94,143,188,0,7,0,23,1102,261,1274,Handler
174,Dylan Tunnell,33,806,1008,204,156,48,14,117,1199,92.09,612,496,116,52.88,59,94,2,7,0,25,709,97,758,
175,Ross Ward,68,853,713,87,25,62,57,117,210,88.98,0,0,0,38.57,28,24,0,3,0,0,88,765,857,Defender
176,Gagan Chatha,25,673,738,144,65,79,21,117,430,89.77,0,0,0,49.32,42,35,1,13,0,18,453,220,587,
177,CJ Colicchio,37,669,577,106,45,61,53,116,339,87.6,4803,1728,3075,43.33,34,38,0,5,0,58,387,282,555,
178,Mike Lee,38,673,772,157,65,92,18,116,420,88.79,1480,733,747,49.22,41,48,0,11,0,34,438,235,631,Cutter
179,Mitchell Steiner,79,1309,999,116,71,45,78,116,831,92.13,1417,636,781,41.14,67,65,0,13,0,260,300,1009,1229,Defender
180,Michael Jordan,52,910,1153,137,33,104,22,115,471,93.82,1609,339,1270,51.08,44,25,2,19,1,32,735,175,919,Cutter
181,Mike Mackenzie,32,634,608,106,43,63,43,114,247,89.17,3668,1015,2653,47.86,29,24,2,11,1,4,223,411,633,Defender
182,Husayn Carnegie,39,549,321,120,31,89,47,114,300,86.71,0,0,0,39.56,13,46,0,7,0,0,264,285,303,
183,Trevor Purdy,48,787,677,95,38,57,45,112,222,91.74,103,10,93,40.92,24,19,0,9,0,6,301,486,722,Defender
184,Kevin Groulx,65,1287,1371,192,94,98,66,111,554,80.06,0,0,0,38.0,54,125,1,22,1,118,579,708,1199,
185,Joshua Wilson,73,1130,776,117,84,33,57,111,781,92.65,2386,1781,605,46.65,61,54,3,9,0,177,204,926,954,
186,Rob Dulabon,34,601,354,117,31,86,47,111,290,90.91,0,0,0,47.46,6,42,0,11,0,13,172,429,364,
187,Nate Page,55,994,908,104,34,70,66,110,325,84.42,0,0,0,39.54,37,50,0,10,0,78,262,732,903,Defender
188,Max Cassell,37,692,892,151,71,80,12,110,688,93.48,0,0,0,52.13,47,46,1,7,0,7,559,133,696,Hybrid
189,Brett Matzuka,66,1599,1566,171,129,42,59,110,2590,94.66,1544,1507,37,48.72,184,112,3,8,0,168,653,946,1673,Handler
190,Dylan Freechild,23,594,630,127,74,53,16,109,575,94.73,0,0,0,54.76,58,27,3,7,0,146,294,300,546,
191,Jay Boychuk,39,747,756,139,54,85,10,109,475,94.06,0,0,0,50.4,56,27,1,13,0,0,400,347,675,
192,Travis Catron,34,910,1082,129,51,78,18,109,639,94.39,0,0,0,56.38,59,31,0,7,0,0,738,172,850,
193,Chris Larberg,57,871,684,89,19,70,37,108,236,94.78,251,51,200,41.67,30,13,1,5,0,0,87,784,815,Defender
194,Timothy Beatty,49,1103,1362,183,132,51,6,108,1812,94.97,0,0,0,53.96,111,74,2,7,0,5,999,104,1077,Handler
195,Caleb Denecour,25,526,740,123,25,98,12,108,327,93.7,0,0,0,47.57,45,17,0,10,0,0,443,83,497,
196,Ken Wells,47,842,854,149,38,111,21,108,293,84.2,0,0,0,36.65,25,46,0,16,0,5,638,204,650,Cutter
197,Henry Fisher,23,476,561,115,29,86,7,108,372,96.12,4359,640,3719,61.32,49,12,1,2,0,1,430,46,475,Cutter
198,Jeremy Langdon,22,513,560,121,48,73,19,107,353,91.69,0,0,0,53.04,36,27,1,6,0,12,278,235,491,
199,Matt Auletta,70,1197,1486,172,98,74,26,107,1253,92.81,0,0,0,45.96,77,82,5,9,0,48,879,318,1218,Cutter
200,Aaron Watson,27,601,754,116,44,72,22,106,507,93.54,0,0,0,51.06,53,26,0,6,0,3,443,158,586,
201,Tim Tsang,38,840,913,162,85,77,38,106,753,87.86,0,0,0,42.28,74,86,1,8,0,168,468,372,801,
202,Sam Fontaine,52,1025,1020,154,88,66,23,105,892,92.34,3804,2441,1363,47.45,71,61,0,11,0,26,565,460,1032,Handler
203,Peter Carleton,77,1378,1048,131,81,50,56,105,470,84.68,0,0,0,37.6,41,71,1,11,0,228,292,1086,1130,
204,Doug Urbino,43,701,594,108,34,74,43,104,296,87.06,0,0,0,30.47,11,35,0,12,0,166,326,375,533,
205,Joe Richards,31,521,524,93,20,73,33,104,124,86.71,2404,401,2003,50.19,11,15,0,7,0,1,261,260,530,
206,Shane Earley,32,610,726,122,30,92,8,104,238,90.49,1771,466,1305,52.62,28,21,0,5,0,0,554,56,590,Cutter
207,Paul Renaud,53,1051,1096,93,40,53,62,103,441,92.84,1446,377,1069,40.69,48,30,0,22,0,7,557,494,990,
208,Gord Harrison,68,1142,839,115,78,37,74,103,808,89.98,0,0,0,45.17,38,81,0,5,0,678,199,943,826,Defender
209,Delrico Johnson,29,669,640,94,30,64,40,102,260,91.55,0,0,0,42.34,25,22,1,10,0,183,241,428,625,Defender
210,Chase Cunningham,49,1251,1261,212,158,54,57,102,1054,85.97,1965,1482,483,42.19,84,152,1,15,0,459,556,695,1178,Handler
211,Nathan Bridges,52,952,822,115,45,70,32,102,678,93.26,105,44,61,40.27,38,40,1,5,0,97,282,670,961,Hybrid
212,Trevor Henry,51,890,621,113,58,55,30,102,293,91.56,0,0,0,48.95,17,24,0,17,0,1,253,637,599,
213,Zane Rankin,28,662,775,138,74,64,26,102,321,83.16,0,0,0,44.65,33,55,0,7,0,66,398,264,641,
214,Greg Marliave,38,663,744,104,39,65,20,101,261,92.23,0,0,0,43.15,25,21,2,2,0,33,311,352,615,
215,Ryan Chard,71,1133,919,80,23,57,52,101,344,93.48,1562,292,1270,35.91,24,23,1,8,0,45,369,764,1044,
216,Joe Ouellette,69,824,471,118,50,68,64,101,369,86.01,82,33,49,41.19,7,62,3,19,0,8,241,583,520,Defender
217,Ben Nelson,82,1268,1215,182,122,60,24,100,1702,93.93,34,43,-9,52.1,120,93,0,13,0,15,663,605,1130,Handler
218,Jonathan Edwards,39,646,642,90,15,75,42,99,183,87.14,1547,237,1310,42.68,14,24,0,9,0,1,230,416,610,
219,Thomas Edmonds,30,664,828,144,88,56,17,99,1389,95.66,5046,2784,2262,50.12,81,54,1,8,0,3,580,84,735,Handler
220,Evan Boucher,29,479,342,130,66,64,10,99,438,94.81,0,0,0,53.51,29,34,0,7,0,8,325,154,268,
221,Cullen Geppert,36,745,541,145,85,60,32,98,611,89.33,0,0,0,43.25,23,65,0,14,0,1,468,277,449,
222,JP Burns,51,959,781,115,48,67,37,98,407,89.45,1360,550,810,43.02,40,42,0,12,1,45,279,680,975,Defender
223,Félix-Antoine Daigle,50,1022,1194,140,86,54,56,97,1244,92.15,0,0,0,39.28,86,89,0,10,0,11,517,505,1026,
224,Cam Bailey,34,811,911,106,25,81,39,97,482,89.42,0,0,0,42.15,48,44,1,4,1,182,395,416,790,Defender
225,Kelly Van Arsdale,29,611,626,114,56,58,27,97,301,88.27,0,0,0,46.01,38,38,2,6,0,17,313,298,533,
226,Sacha Poitte-Sokolsky,21,440,587,120,38,82,7,97,407,94.21,3664,786,2878,54.0,37,22,0,8,0,0,413,27,499,
227,Josh Hartzog,67,1126,745,95,44,51,31,97,273,90.4,697,263,434,47.38,30,25,0,4,0,155,74,1052,1123,Cutter
228,Jakeem Polk,58,1027,717,81,21,60,49,97,168,88.89,639,140,499,40.31,17,17,1,16,0,100,153,874,983,Defender
229,Tim Okita,38,817,1020,140,99,41,7,96,1406,96.57,2816,2056,760,56.96,71,41,0,10,0,0,744,73,836,
230,Barrs Lang,28,539,602,117,44,73,13,96,261,90.0,0,0,0,45.51,24,27,0,7,0,155,273,266,489,
231,TJ Burns,37,653,419,136,44,92,36,96,416,88.89,0,0,0,30.07,16,55,0,21,0,6,418,235,354,
232,Michael Matthis,47,926,941,109,48,61,40,95,429,89.38,468,107,361,38.26,41,44,0,10,0,24,400,526,886,Defender
233,Zack Avello,44,859,862,110,32,78,18,95,272,89.77,0,0,0,39.33,30,25,0,8,1,1,490,369,815,
234,David Ferraro,34,630,649,92,23,69,44,95,318,91.64,0,0,0,36.06,23,28,1,13,0,1,312,318,554,
235,Andrew Moore,39,720,660,87,27,60,39,95,264,91.03,2612,819,1793,39.55,26,23,3,8,0,0,253,467,691,
236,Jarrett Bowen,25,496,646,137,58,79,9,95,286,87.73,0,0,0,53.56,34,36,0,15,0,0,425,71,459,
237,Bretton Tan,38,694,656,64,14,50,53,95,228,91.94,0,0,0,40.7,16,15,0,7,0,1,157,537,667,Defender
238,Chuck Cao,51,1238,1526,172,140,32,21,95,1794,94.87,0,0,0,49.93,101,85,4,13,0,8,927,311,1164,
239,Jibran Mieser,36,657,642,106,34,72,42,95,488,90.54,0,0,0,53.43,56,43,1,10,0,0,507,150,533,Cutter
240,Josh Bush,32,596,661,108,43,65,17,94,256,90.46,0,0,0,51.13,25,23,0,8,0,81,413,183,556,Cutter
241,Jerrod Wolfe,28,573,586,99,36,63,23,93,217,87.85,0,0,0,39.93,24,25,0,4,0,8,250,323,541,
242,Joel Schlachet,17,408,496,114,39,75,11,93,420,94.38,0,0,0,53.83,47,24,0,8,0,0,312,96,354,
243,Kaplan Maurer,35,661,692,116,58,58,17,93,629,93.74,3172,1391,1781,43.06,49,36,0,4,1,4,312,349,707,
244,Ryan Gorman,24,603,504,97,39,58,36,92,834,95.31,0,0,0,37.1,31,37,0,4,2,4,455,148,355,
245,Tarik Akyuz,32,622,794,108,32,76,21,92,358,91.33,1743,487,1256,42.95,45,27,0,10,0,8,519,103,663,Cutter
246,David Schleicher,28,420,341,118,34,84,4,92,369,95.1,0,0,0,49.85,13,18,0,12,0,0,318,102,258,
247,Colin Berry,39,754,699,91,42,49,43,92,297,88.66,1244,650,594,37.77,26,34,0,8,0,65,142,612,780,Defender
248,Chris LaRocque,34,848,832,124,92,32,23,91,844,93.47,0,0,0,49.04,58,44,1,12,0,45,395,453,846,Hybrid
249,Dillon Larberg,55,1070,982,153,117,36,87,91,841,84.61,697,592,105,40.63,54,139,3,10,1,241,201,869,1083,Defender
250,Andrew Sjogren,26,581,733,106,21,85,8,91,394,96.1,4529,350,4179,37.52,49,11,0,12,0,0,497,84,660,
251,David Valentine-Elam,42,572,515,122,71,51,23,91,444,90.43,0,0,0,44.47,26,44,0,10,0,2,469,103,334,
252,Brian Casey,37,774,1028,140,95,45,15,90,1010,92.92,0,0,0,52.24,71,59,0,6,0,2,685,89,728,
253,Mitchell Bennett,30,609,815,111,48,63,14,90,352,91.43,0,0,0,49.45,43,28,1,7,1,3,505,104,562,Hybrid
254,Charles Weinberg,26,513,641,111,49,62,9,90,493,93.55,3258,1465,1793,53.67,50,27,1,3,0,5,454,59,532,Cutter
255,Stanley Peterson,21,463,549,88,34,54,21,90,232,93.17,0,0,0,53.19,28,15,1,4,1,0,289,174,436,
256,Andrew Ouchterlony,55,1133,1470,122,69,53,28,90,645,91.1,727,222,505,42.79,66,51,2,9,0,2,938,195,1084,Hybrid
257,Nate Botti,30,587,356,156,98,58,22,89,514,86.24,0,0,0,33.99,5,78,0,11,0,2,353,234,288,
258,Kyle Stapleton,51,1079,1238,122,79,43,24,89,1487,95.81,0,0,0,53.15,102,53,4,4,2,64,806,273,1005,Handler
259,Jean-Levy Champagne,40,770,784,93,38,55,35,89,363,89.85,0,0,0,39.16,25,31,0,8,0,23,329,441,733,
260,Andrew Brown,77,1324,1408,156,121,35,18,89,2890,96.49,0,0,0,49.64,157,72,14,13,0,3,1100,224,1118,Handler
261,David Snoke,36,773,1030,133,80,53,26,89,1208,93.5,0,0,0,52.62,88,63,3,7,1,1,696,77,745,Handler
262,Chase Marty,47,645,478,68,18,50,27,89,126,96.92,838,147,691,53.77,15,2,0,4,0,0,91,554,645,
263,Aaron Schwartz,57,1091,1230,120,39,81,30,88,450,89.11,0,0,0,47.8,53,47,0,15,0,1,632,459,1003,Cutter
264,Tim Settles,34,796,1139,124,53,71,35,88,809,90.8,0,0,0,34.86,56,66,1,5,0,2,675,121,839,
265,Jon Pressimone,46,827,529,118,33,85,26,88,247,84.01,0,0,0,43.48,26,42,1,14,0,37,390,437,487,
266,Remi Ojo,51,663,600,61,20,41,59,88,133,84.18,87,4,83,40.5,15,23,0,9,1,1,59,604,643,Defender
267,Ashlin Joye,29,805,1020,150,123,27,25,88,1256,93.24,0,0,0,53.82,88,80,5,7,0,18,611,194,773,
268,Matt LeMar,122,2088,1455,179,114,65,60,88,1054,87.11,716,638,78,42.13,78,139,3,12,0,51,203,1885,1871,Defender
269,Benjamin Parris,31,512,298,138,56,82,24,88,436,92.57,0,0,0,47.32,11,52,0,22,0,0,310,202,212,
270,Sam Cook,32,648,742,98,38,60,16,87,410,93.82,3270,1275,1995,45.69,31,24,2,3,0,3,456,192,694,Cutter
271,Kevin Richardson,23,516,636,89,24,65,13,87,466,97.08,931,482,449,53.93,51,11,0,4,1,0,438,78,509,
272,Christian Johnson,21,518,629,112,54,58,15,87,346,91.29,0,0,0,50.72,49,30,0,10,0,1,361,157,456,
273,Rory Orloff,44,899,1005,122,36,86,15,86,635,92.3,18,11,7,43.38,34,44,0,7,0,11,557,342,865,
274,Kielan Way,24,558,713,135,87,48,15,86,604,89.61,0,0,0,46.7,52,60,1,4,0,0,434,124,548,
275,Tim Kominos,52,748,613,66,18,48,48,86,137,87.82,0,0,0,28.38,10,14,0,14,0,90,178,570,666,
276,John Korber,12,266,0,87,19,68,8,86,35,,0,0,0,,0,6,0,3,0,0,158,108,0,
277,Mike Swain,54,736,531,87,29,58,41,85,311,88.35,0,0,0,46.14,22,34,2,9,1,5,161,575,499,
278,Jake Wright,38,832,1040,150,48,102,12,85,455,85.53,0,0,0,40.67,36,67,0,10,0,8,632,200,804,
279,Eric Nardelli,66,1208,1090,91,38,53,64,85,393,85.62,1208,881,327,29.91,20,55,1,15,0,30,324,884,1240,Cutter
280,Brad Scott,44,866,758,81,35,46,45,85,263,86.23,0,0,0,38.65,21,37,0,4,0,2,177,689,801,Defender
281,Keenan Laurence,22,461,429,86,42,44,17,84,231,91.67,3546,1244,2302,47.55,21,15,0,4,0,0,278,183,427,
282,Grant Lindsley,19,476,491,106,57,49,9,84,466,93.57,0,0,0,61.51,48,27,2,4,0,0,380,96,412,Hybrid
283,Andy Barnhart,61,876,897,96,47,49,61,84,453,87.12,0,0,0,31.33,23,60,1,13,0,120,476,400,778,
284,Zach Sabin,19,439,479,81,32,49,23,83,219,92.8,0,0,0,49.9,30,15,0,6,0,23,280,159,405,
285,Eli Friedman,25,576,717,122,69,53,12,83,843,93.56,0,0,0,50.35,54,49,1,2,0,21,497,79,571,
286,Sam Gainer,36,777,858,121,62,59,13,83,479,90.72,261,75,186,52.21,63,45,0,6,0,1,578,199,711,Cutter
287,Pat Earles,25,649,860,184,151,33,12,82,1000,88.34,0,0,0,50.58,70,102,4,12,0,7,542,107,644,
288,Sam VanDusen,50,1292,1164,207,161,46,52,82,967,82.58,3074,2092,982,41.92,72,168,7,9,0,746,424,868,1246,Handler
289,Himalaya Mehta,22,441,632,101,21,80,16,82,371,92.98,0,0,0,45.25,43,23,0,12,0,0,384,57,515,Cutter
290,Sonny Zaccaro,63,1326,1413,131,94,37,32,82,1514,94.57,0,0,0,49.4,112,75,3,6,0,8,719,607,1204,
291,Eric Johnson,38,672,906,91,27,64,24,81,300,90.63,0,0,0,42.05,33,25,0,9,0,1,509,163,698,
292,Morgan Hibbert,27,616,628,77,35,42,45,81,276,87.34,0,0,0,39.01,24,35,0,6,0,183,267,349,576,Cutter
293,Francis Vallée,43,728,840,100,38,62,25,81,439,90.89,0,0,0,41.07,35,38,1,6,0,18,409,319,708,
294,Ryan Tucker,28,392,504,77,25,52,17,81,123,94.62,0,0,0,53.37,18,6,0,7,0,0,312,80,388,Cutter
295,Jean-Philippe Riopel,50,663,776,86,24,62,19,81,184,91.54,0,0,0,41.75,17,15,0,9,0,1,376,287,634,
296,Chris Wilen,43,698,655,87,29,58,27,81,289,91.75,2836,833,2003,46.87,32,20,1,13,0,5,301,397,680,Cutter
297,Anatoly Vasilyev,43,962,1010,115,96,19,34,81,950,92.59,0,0,0,45.25,94,61,1,7,0,25,278,684,962,Handler
298,Alex Thomas,33,564,479,59,11,48,41,81,148,92.5,0,0,0,37.79,17,10,0,9,0,2,134,430,581,Defender
299,Alan Kolick,22,525,630,102,60,42,23,81,620,93.37,0,0,0,49.21,45,35,4,9,0,0,317,208,517,
300,Gus Misleh,30,567,800,138,60,78,29,80,406,83.71,0,0,0,35.5,32,73,0,14,0,3,463,104,552,
301,Jake Coleman,40,660,575,59,6,53,42,80,93,88.57,51,2,49,35.65,9,10,1,11,0,8,129,531,618,Defender
302,Maxwell Hume,62,1206,1005,119,45,74,31,80,532,88.23,427,151,276,42.69,52,54,0,16,0,2,392,814,1156,Cutter
303,Trenton Spinks,66,1253,1120,71,28,43,48,79,502,92.96,228,88,140,46.16,56,32,0,8,0,1,515,738,1217,
304,Michael Egan,70,829,551,74,23,51,47,79,218,86.51,0,0,0,38.11,20,31,0,11,0,2,122,707,602,
305,Jason Huynh,46,854,787,104,50,54,24,79,597,92.41,1844,884,960,44.35,61,41,0,8,0,0,271,583,870,
306,Brodie Smith,31,408,123,139,122,17,19,79,624,89.66,0,0,0,52.03,5,70,0,9,0,23,228,180,89,
307,Jeff Weis,30,709,765,85,25,60,32,79,422,90.95,266,42,224,46.54,38,31,0,7,1,27,398,311,689,Defender
308,Sean Murray,16,181,0,70,27,43,23,78,93,86.92,0,0,0,,0,14,0,1,0,0,86,95,0,
309,Aaron Weaver,37,650,544,70,36,34,23,78,426,96.82,0,0,0,50.55,43,10,0,5,0,3,193,457,597,Hybrid
310,Logan Pruess,52,1086,1042,108,70,38,42,78,1080,93.02,3267,2987,280,48.56,79,63,4,9,1,37,354,732,1123,Hybrid
311,Bill Everhart,53,1062,1101,104,58,46,26,78,904,95.06,0,0,0,45.05,87,40,2,12,0,3,268,794,1124,
312,Joey Cari,58,936,1072,143,81,62,32,78,1079,92.14,0,0,0,46.08,79,77,0,20,0,1,709,227,784,Hybrid
313,Brian Magerr,36,694,898,107,42,65,24,77,461,91.11,0,0,0,35.75,39,35,0,19,0,1,536,158,713,
314,Aaron Del Real,43,786,1022,135,52,83,28,77,418,86.72,0,0,0,32.58,26,61,0,25,0,7,635,151,763,
315,Jon DeAmicis,52,805,631,44,14,30,55,77,111,85.38,171,79,92,37.4,14,13,0,9,0,15,87,718,746,Defender
316,Anders Juengst,15,287,344,84,29,55,4,76,364,96.3,4826,1751,3075,65.7,30,11,0,1,0,0,286,1,290,Hybrid
317,Shane Worthington,36,724,537,59,14,45,54,76,182,83.87,1992,864,1128,36.87,22,26,1,11,0,57,148,576,674,Cutter
318,Tyler Monroe,22,413,533,110,61,49,8,76,462,92.59,0,0,0,54.22,38,33,0,9,1,0,354,59,395,
319,Max Thorne,15,374,509,100,55,45,8,75,511,93.25,0,0,0,48.33,39,32,0,1,0,0,319,55,377,
320,Eddie Mack,51,1029,1164,129,61,68,24,75,1167,94.19,0,0,0,36.68,49,60,0,18,0,0,911,118,834,
321,Patrick Baylis,35,777,833,82,52,30,36,74,683,92.93,0,0,0,46.58,57,44,0,0,0,44,368,409,729,
322,Parker Bray,32,640,616,125,90,35,25,74,561,87.25,3750,2477,1273,46.92,40,68,0,8,0,65,336,304,695,Handler
323,Charlie Muniz,49,913,977,126,65,61,30,74,678,90.88,0,0,0,46.47,61,64,3,18,0,18,560,353,882,Defender
324,Daniel Selwyn,43,946,488,124,108,16,53,74,1249,92.25,0,0,0,40.16,31,95,0,8,0,366,385,561,517,
325,Danny Landesman,17,325,398,84,26,58,6,74,237,94.05,2321,594,1727,52.76,24,12,0,4,0,1,278,47,344,Hybrid
326,Kevin Underhill,18,501,589,100,60,40,14,73,778,93.62,0,0,0,50.59,60,40,4,1,0,29,379,122,452,
327,Paul Mensah,53,769,570,46,3,43,47,73,75,,59,-7,66,30.88,14,10,0,10,0,1,86,683,731,
328,Brandon Severson,33,515,422,49,23,26,34,73,183,93.85,0,0,0,39.34,16,9,0,1,0,27,70,445,483,
329,Marijo Zlatic,30,483,388,52,18,34,34,73,139,94.56,0,0,0,44.59,17,7,0,6,0,1,51,432,440,Defender
330,Isaac Leonard,31,473,352,52,18,34,26,73,124,95.38,1098,379,719,43.18,16,5,0,0,1,0,60,413,464,Defender
331,Jacob Fella,38,663,563,63,20,43,47,72,172,84.73,594,63,531,39.61,16,28,1,10,1,16,157,506,671,Defender
332,Greg Ellis,49,1105,1286,150,73,77,26,72,927,90.7,2540,1893,647,45.96,73,80,3,24,0,38,713,392,1050,
333,Malik Auger-Semmar,41,780,802,102,48,54,24,72,345,87.56,3817,1074,2743,40.02,34,43,1,11,0,8,376,404,760,
334,Drew Swanson,22,430,273,35,3,32,44,72,49,,391,8,383,41.03,5,3,0,4,0,0,46,384,454,
335,Justin Solis,22,468,452,95,33,62,13,72,274,90.43,0,0,0,46.24,19,24,0,12,0,0,406,62,364,
336,Kevin Cocks,45,846,719,85,40,45,32,71,264,87.13,0,0,0,42.84,24,37,1,9,0,1,156,690,758,
337,Michael Tran,47,879,934,111,63,48,18,71,1249,95.86,1561,1114,447,55.03,83,50,2,8,0,7,568,311,898,
338,Casey Wu,31,480,545,90,20,70,6,71,275,94.5,0,0,0,47.34,23,14,0,11,0,0,368,112,449,
339,Will Griffin,40,864,857,107,74,33,27,71,779,92.85,0,0,0,42.59,54,56,2,7,0,20,435,429,850,Hybrid
340,Adam Simon,33,731,843,111,66,45,14,71,689,91.74,1455,990,465,50.42,42,50,1,4,0,66,537,194,680,Handler
341,Kevin Kelly,28,530,294,94,43,51,24,70,306,88.95,0,0,0,42.18,16,34,0,14,0,35,248,282,285,
342,Ken Alexander,42,796,1091,124,62,62,13,70,505,89.54,0,0,0,46.1,46,51,0,16,0,0,723,73,765,Cutter
343,Andre Gailits,20,515,586,80,33,47,12,70,363,94.29,0,0,0,50.68,37,20,2,2,0,5,386,129,447,
344,Tanner Repasky,35,642,679,85,34,51,11,70,372,94.66,148,67,81,46.24,36,18,1,8,0,1,411,231,684,
345,Cam Burden,23,479,586,95,50,45,16,70,545,91.44,0,0,0,49.15,47,41,0,0,0,8,341,138,498,Handler
346,Josue Alorro,60,1210,1232,147,94,53,34,70,1273,92.05,664,488,176,45.29,106,101,1,10,0,205,583,627,1316,Handler
347,Markham Shofner,20,425,525,84,52,32,15,70,372,90.73,0,0,0,49.71,17,27,0,2,0,35,304,121,418,
348,Kevin Coulter,14,370,445,107,55,52,16,70,309,86.31,0,0,0,37.75,14,45,0,8,0,46,271,99,385,
349,Mark Worsfold,21,195,0,81,18,63,13,69,158,94.05,0,0,0,,0,20,0,5,0,0,86,109,0,
350,Michael Jones,61,1141,790,86,63,23,48,69,1067,94.09,0,0,0,47.72,68,56,0,9,0,74,352,789,733,Handler
351,Andrew Kubinec,36,553,237,70,35,35,33,69,166,84.26,0,0,0,50.21,11,30,0,4,0,39,138,415,231,
352,Joel Clutton,41,696,658,46,9,37,47,68,199,90.05,0,0,0,34.95,26,19,0,6,0,10,144,552,652,Defender
353,Ricky Szeto,26,342,147,69,6,63,17,68,65,,0,0,0,48.3,3,8,0,10,0,1,57,285,141,
354,Zac Schakner,71,1200,955,88,62,26,45,68,596,90.03,545,255,290,41.68,58,59,1,6,1,56,197,1003,1167,Defender
355,David Boylan-Kolchin,28,490,603,76,26,50,23,68,203,87.88,0,0,0,45.61,24,25,1,6,0,1,339,151,458,
356,Phil Turner,27,448,339,38,8,30,45,68,82,,1250,302,948,36.87,6,11,0,4,0,105,54,394,493,
357,Christophe Tremblay-Joncas,42,751,560,46,17,29,44,68,162,91.01,1540,474,1066,33.21,19,14,0,8,0,323,122,629,710,
358,Tim McAllister,41,784,612,61,37,24,36,67,176,87.13,655,286,369,36.6,16,21,0,9,0,150,95,689,810,Cutter
359,Evan Klein,17,413,420,82,46,36,29,67,214,83.92,0,0,0,38.33,25,39,0,5,1,25,131,282,402,
360,Pat Niles,27,475,291,87,46,41,18,67,306,88.95,0,0,0,42.61,12,30,0,8,0,2,349,126,234,
361,Nasser M'Bae Vogel,35,587,726,91,42,49,18,67,409,90.69,401,212,189,43.25,54,35,0,7,0,16,418,169,610,Cutter
362,David Shirley,36,663,752,80,32,48,36,67,416,89.08,0,0,0,38.16,29,39,0,10,0,7,290,373,664,
363,Connor Olson,37,625,617,76,31,45,14,67,502,95.44,1035,531,504,52.67,45,20,0,3,0,49,353,272,625,
364,Evan Brydon,25,514,575,79,21,58,18,66,281,90.65,0,0,0,49.04,39,26,0,5,0,34,336,178,468,
365,Jake Rainwater,16,203,0,76,27,49,19,66,146,88.48,0,0,0,,0,19,0,10,0,0,120,83,0,
366,Ryan Mariouw,27,559,823,83,23,60,29,66,281,88.36,0,0,0,32.93,21,33,0,13,0,1,461,98,621,Cutter
367,David Hortemiller,33,545,351,73,20,53,20,66,158,90.29,0,0,0,44.16,16,13,0,14,0,0,232,313,355,
368,Mark Whitton,31,556,585,75,29,46,27,66,186,86.92,0,0,0,30.09,15,23,0,13,0,22,258,298,563,
369,Jonathan Mast,73,1528,1963,147,113,34,28,65,2719,95.54,3068,2533,535,49.36,210,105,2,5,2,1,1224,304,1593,Handler
370,Derek Alexander,47,1274,1730,231,194,37,17,65,2314,91.9,0,0,0,44.45,153,165,10,18,0,0,1139,135,1244,Handler
371,Garrett Braun,23,402,497,78,43,35,8,65,473,96.93,3101,1349,1752,60.76,47,14,0,7,0,0,367,35,454,
372,Hunter Taylor,30,517,404,40,16,24,45,65,148,89.7,993,429,564,38.86,11,14,0,6,0,57,81,436,495,Defender
373,Tyler Latham,22,352,397,52,21,31,27,65,103,93.64,0,0,0,36.52,13,7,0,7,0,1,163,189,338,
374,Elliott Moore,38,625,583,70,32,38,27,64,231,88.51,1841,932,909,39.11,18,26,0,7,1,0,214,411,625,
375,Miguel Goderre,52,1080,1322,107,60,47,30,64,1298,94.26,1940,1571,369,42.66,92,63,2,10,0,1,732,348,1121,
376,Avery Johnson,34,495,636,86,25,61,3,64,331,94.03,1831,417,1414,55.5,31,16,0,9,0,0,464,31,524,Cutter
377,Leon Forest-Nault,35,694,957,89,33,56,15,64,462,93.33,0,0,0,43.05,50,28,1,12,0,1,610,84,685,
378,David Meinecke,40,580,526,67,29,38,26,64,169,89.42,0,0,0,46.96,18,19,0,10,0,116,96,484,548,Defender
379,Phil Murray,21,444,509,85,49,36,14,64,293,89.6,0,0,0,52.85,37,27,0,8,0,6,322,122,386,
380,Anthony Davis,25,486,623,80,13,67,22,63,223,91.02,484,50,434,33.39,17,19,0,20,0,0,316,170,557,
381,Ray Illian,11,256,302,61,24,37,16,63,120,91.6,0,0,0,55.3,13,8,0,6,0,2,175,81,228,
382,Doug Richardson,42,769,844,98,47,51,18,63,765,93.41,0,0,0,42.3,67,45,2,8,1,45,422,347,726,
383,Josh Hemmesch,21,369,186,76,38,38,17,63,268,91.16,0,0,0,44.09,9,21,0,9,0,0,238,131,175,
384,Trey Katzenbach,40,728,760,80,46,34,18,63,915,96.52,0,0,0,47.5,35,29,1,6,0,0,570,158,595,Hybrid
385,Gary LeDonne,28,354,119,53,16,37,28,63,191,93.17,0,0,0,43.7,5,13,1,5,0,21,64,290,132,
386,Greg Strouse,21,451,586,66,19,47,17,63,184,90.2,0,0,0,41.64,16,16,0,4,0,1,393,58,459,
387,Micah Hood,37,747,855,117,70,47,20,62,483,85.64,0,0,0,39.65,29,67,3,8,0,29,450,297,765,
388,Carlos Wolle,21,388,488,60,18,42,22,62,212,92.17,0,0,0,36.27,22,14,1,6,0,1,222,166,403,
389,Jason Yun,29,410,419,68,18,50,17,62,128,87.07,0,0,0,44.39,16,17,0,6,0,1,156,254,344,
390,Vincenzo Vitiello,32,669,731,71,29,42,24,62,335,91.53,0,0,0,47.74,42,28,1,5,0,17,398,271,597,
391,AJ Merriman,25,447,317,50,25,25,32,62,108,85.71,2043,809,1234,43.85,10,14,0,6,1,117,68,379,449,
392,William Hoehne,38,659,541,87,36,51,25,62,291,84.84,0,0,0,39.56,21,44,0,6,0,143,344,315,470,
393,Casey Degnan,28,315,105,55,9,46,21,62,70,,0,0,0,42.86,1,9,0,5,0,2,20,295,136,
394,Federico Chialvo,40,910,975,107,59,48,28,62,754,91.73,0,0,0,45.23,53,61,1,12,0,212,405,505,847,
395,Steve Mogielski,65,934,746,69,24,45,33,62,242,88.0,485,103,382,43.03,36,31,0,9,0,90,190,744,842,
396,John Carden,46,762,659,53,20,33,34,61,182,89.22,0,0,0,29.44,13,16,3,10,0,0,267,495,673,
397,Sam Taylor,54,910,982,68,29,39,41,61,489,91.4,0,0,0,39.82,48,40,3,8,0,411,294,616,998,
398,Mark Lin,36,566,691,88,44,44,21,61,399,88.08,959,666,293,47.76,34,43,0,5,0,8,391,175,552,
399,AJ Jacoski,41,606,461,58,22,36,25,61,182,88.78,0,0,0,42.73,18,18,1,4,0,189,79,527,517,Defender
400,Schuyler Redding,27,362,214,82,40,42,27,61,224,87.5,0,0,0,35.05,6,38,0,10,0,1,172,190,201,
401,Player Pierce,49,934,873,119,98,21,27,61,1089,92.84,1899,1501,398,48.91,86,81,3,4,0,234,564,370,899,
402,Ben Ayres,19,287,0,85,34,51,18,61,296,95.48,0,0,0,,0,31,0,11,0,0,145,142,0,
403,Brian Marshall,23,453,369,51,14,37,25,61,140,93.96,0,0,0,42.28,17,9,1,6,0,37,59,394,438,
404,Ryan Purcell,47,1024,1224,156,124,32,20,60,1389,91.74,607,651,-44,44.93,94,106,2,10,0,19,690,334,978,Handler
405,Victor Luo,40,600,628,90,62,28,19,60,914,94.13,4539,2787,1752,47.93,59,45,2,4,0,74,304,296,651,
406,Zeke Ivers,33,699,823,117,79,38,10,60,782,92.0,0,0,0,50.67,50,57,0,10,0,19,528,171,665,Handler
407,Isaac Jeffries,36,558,380,83,31,52,25,60,425,91.01,0,0,0,32.11,17,40,0,8,0,46,365,193,342,
408,Will Lindquist,21,314,313,61,25,36,8,60,149,93.71,972,346,626,57.83,11,8,0,1,0,0,208,106,300,
409,Ben Lohre,20,464,561,69,29,40,10,60,403,95.5,0,0,0,50.98,40,14,0,5,0,12,291,173,460,
410,Elliott Chartock,23,555,678,95,70,25,15,60,1113,95.21,6255,4890,1365,55.31,67,48,3,2,0,0,485,70,571,Handler
411,Jason Tschida,28,625,807,81,42,39,22,60,1086,95.94,0,0,0,45.23,57,36,3,7,0,3,436,189,631,Handler
412,David Wheeler,22,281,0,77,30,47,28,60,242,88.32,0,0,0,,0,32,0,13,0,0,201,80,0,
413,Scott Trimble,43,735,771,74,32,42,29,60,229,87.4,0,0,0,41.25,16,24,0,19,2,30,349,386,664,Defender
414,Kevin Baumann,25,311,201,87,37,50,5,60,189,89.15,0,0,0,40.8,10,21,0,11,0,0,223,88,151,
415,Jordan Marcy,37,846,1069,76,40,36,19,60,1055,96.44,0,0,0,51.08,79,29,1,6,0,3,615,231,816,
416,Kenny Furdella,37,772,845,74,34,40,19,60,742,95.99,1569,1260,309,45.21,30,26,0,7,0,2,458,314,776,
417,Alex Thorne,32,703,953,143,104,39,5,60,1259,92.85,2138,1489,649,49.32,97,82,4,6,0,4,629,74,725,Handler
418,Tanner Halkyard,10,238,267,65,31,34,11,59,158,91.33,3985,1164,2821,60.3,18,12,1,5,0,0,213,25,229,
419,Andrew Berry,28,502,583,89,41,48,5,59,262,89.42,0,0,0,48.89,35,27,0,8,0,0,371,131,437,
420,Max Leonard,22,518,661,90,54,36,6,59,787,94.93,0,0,0,50.83,53,34,1,3,0,1,474,44,488,
421,Chris Powers,26,515,317,123,93,30,10,59,858,91.86,0,0,0,35.33,12,68,2,6,0,0,470,45,214,
422,Eric Brodbeck,18,323,309,66,30,36,12,59,310,94.22,4425,2192,2233,49.84,25,16,0,3,0,3,166,157,327,
423,Michael Fairley,26,516,458,66,29,37,16,59,316,92.94,1548,1116,432,53.71,24,19,0,4,0,40,260,256,537,
424,Sam Hart,16,309,257,40,11,29,25,59,86,,0,0,0,46.3,10,5,0,1,0,16,79,230,282,
425,Jack Shanahan,19,404,467,76,35,41,7,58,261,91.9,1684,698,986,59.53,20,20,0,5,0,2,353,51,414,
426,Nathan Prior,32,675,875,87,68,19,13,58,1409,96.37,0,0,0,52.69,89,38,1,4,0,7,555,120,740,Handler
427,Byron Liu,29,556,581,61,38,23,29,58,266,87.21,0,0,0,44.41,26,30,0,2,0,1,215,341,513,Hybrid
428,Billy Katz,38,637,733,103,72,31,24,58,805,91.89,0,0,0,43.93,51,65,0,4,0,30,453,184,574,
429,Jared Payne,29,369,10,95,57,38,5,57,242,86.74,0,0,0,,0,37,0,6,0,1,236,133,8,
430,Ben Dieter,26,549,729,78,34,44,6,57,411,95.8,0,0,0,53.36,58,15,0,12,0,0,489,60,515,Hybrid
431,Tom Doi,25,539,633,104,56,48,21,57,432,87.8,0,0,0,45.34,57,56,0,12,0,5,367,172,516,
432,Reid Koss,26,654,629,90,58,32,29,57,323,84.55,0,0,0,43.56,29,51,0,11,0,292,257,397,627,
433,Michael Ford,34,486,180,79,64,15,27,57,289,84.75,0,0,0,31.11,9,45,0,4,0,146,118,368,192,
434,Blake Waldron,37,914,1188,170,129,41,21,57,1430,91.02,0,0,0,43.94,83,120,3,14,0,41,771,143,855,
435,Matt O'Brien,49,877,731,60,15,45,40,57,204,85.71,689,188,501,34.75,19,26,0,17,1,23,143,734,842,
436,Bryson Simon-Fox,35,669,713,69,28,41,24,57,275,88.71,0,0,0,50.91,42,29,0,7,0,40,400,269,641,
437,Joc Jimenez,13,270,283,59,17,42,9,56,132,91.67,0,0,0,58.66,19,9,0,3,0,2,189,81,247,
438,Brendan Wong,16,300,336,59,26,33,14,56,170,89.95,0,0,0,43.45,11,13,0,4,0,2,183,117,278,
439,Jeff Loskorn,33,777,1042,128,96,32,37,56,1315,91.64,0,0,0,46.64,80,99,1,10,0,19,583,194,805,Handler
440,Mac McClellan,33,544,628,78,39,39,15,56,657,94.81,192,218,-26,48.89,35,31,0,6,0,2,394,150,540,
441,Billy O'Bryan,34,796,843,121,72,49,24,56,934,91.48,3929,2038,1891,41.87,47,78,1,11,1,99,484,312,860,
442,Charlie McCutcheon,31,552,432,33,9,24,32,56,135,94.41,788,125,663,39.81,13,5,0,4,0,0,64,488,565,Defender
443,Gabriel Monfette,81,1357,1299,97,57,40,57,56,801,88.31,1172,356,816,38.57,50,94,2,4,0,4,373,984,1379,
444,Scott Radlauer,38,627,510,49,20,29,33,55,202,88.6,449,195,254,41.57,14,18,1,9,0,16,160,467,661,
445,Nick Vogt,12,237,270,47,12,35,12,55,148,96.73,2868,328,2540,59.26,17,3,0,1,1,0,205,32,241,
446,Mike Voelpel,24,523,640,66,3,63,15,55,143,89.38,0,0,0,45.0,21,14,0,12,0,0,400,123,468,Cutter
447,Conner Henderson,39,543,439,56,24,32,21,55,343,93.97,2052,1234,818,43.51,24,15,1,7,0,2,176,367,529,
448,Jadon Scullion,58,899,849,108,70,38,28,55,1013,92.17,0,0,0,49.23,56,74,1,7,0,91,543,356,670,
449,Michael Hickson,21,425,501,68,33,35,15,55,341,91.18,0,0,0,51.1,33,26,1,2,0,12,318,107,409,
450,Jacob Mouw,36,494,538,57,18,39,12,55,238,95.2,64,32,32,58.36,30,11,0,3,0,1,350,144,424,Cutter
451,Pat Jensen,14,278,205,45,12,33,25,55,154,96.25,0,0,0,47.32,15,4,1,11,0,0,143,135,181,
452,Andrew Carleton,44,809,861,64,25,39,12,55,413,96.05,0,0,0,48.2,34,13,0,8,0,0,501,308,695,
453,Nima Mostaghim,38,524,434,54,30,24,24,54,229,91.6,0,0,0,45.85,22,17,0,7,0,7,166,358,403,
454,Antoine Lepagnol,20,341,455,79,44,35,12,54,198,83.54,0,0,0,41.76,19,31,0,6,1,19,277,64,315,
455,CJ O'Brien,38,553,471,58,29,29,27,54,198,87.22,0,0,0,36.73,15,28,1,3,0,0,194,359,471,
456,Stephen Poulos,45,948,1169,196,159,37,13,54,1234,88.21,1305,1120,185,47.73,96,142,0,13,0,67,730,218,940,Handler
457,Joey Cretella,41,814,690,67,36,31,39,54,331,87.57,261,47,214,39.57,35,36,0,16,0,100,193,621,796,Hybrid
458,Geoff Bevan,45,899,882,108,73,35,13,54,687,88.99,3067,2156,911,40.93,39,63,2,4,0,316,407,492,892,
459,John Jones,40,521,393,31,6,25,37,54,69,,0,0,0,38.93,8,10,0,4,0,0,59,462,457,
460,Nate Ransom,50,858,787,78,44,34,31,53,730,92.41,850,490,360,47.78,52,53,1,3,0,34,336,522,906,Handler
461,Zach Marbach,30,443,417,37,12,25,27,53,94,93.07,56,-19,75,34.53,9,7,2,4,0,1,80,363,464,
462,Will Turner,39,785,661,56,35,21,41,53,634,92.69,1033,715,318,43.57,45,39,1,5,0,246,204,581,843,
463,Sean Sears,29,456,352,40,7,33,20,52,59,,0,0,0,34.94,10,7,0,1,0,0,74,382,437,
464,Nick Mahan,36,682,426,33,12,21,35,52,113,91.13,944,343,601,36.38,12,7,0,9,0,3,72,610,613,Cutter
465,John Lithio,14,315,382,55,10,45,7,52,186,95.38,4446,974,3472,60.47,26,8,0,2,0,0,312,3,333,Cutter
466,Michael Spear,32,661,648,83,56,27,26,52,358,85.85,0,0,0,45.52,37,51,1,6,0,147,262,399,575,
467,Sawyer Thompson,22,464,437,65,28,37,18,52,166,85.13,3156,1121,2035,45.08,16,27,1,4,0,11,188,276,429,
468,Zach Norrbom,36,539,515,79,44,35,9,52,881,97.13,2954,1750,1204,56.7,43,22,3,14,0,0,426,113,475,Handler
469,Andrew McKelvey,50,691,504,56,17,39,24,52,182,89.22,384,15,369,49.01,22,20,0,8,0,1,158,533,617,Cutter
470,Jake Anderson,19,353,294,39,14,25,20,51,82,,0,0,0,46.26,13,5,0,3,0,3,21,332,310,
471,Philippe Thivierge,36,595,558,38,16,22,42,51,223,86.43,0,0,0,38.35,18,25,0,4,0,136,134,461,591,
472,Scott Westwell,31,696,781,89,41,48,15,51,610,91.04,0,0,0,37.26,39,43,0,10,0,12,342,354,651,
473,Von Alanguilan,50,690,641,45,12,33,34,51,254,93.04,268,46,222,35.73,24,14,1,14,0,2,145,545,734,
474,Adam Drews,56,882,952,110,68,42,25,51,1059,92.33,0,0,0,47.69,96,74,3,10,1,40,285,597,912,Handler
475,Logan Vantrease,24,314,0,67,38,29,24,51,298,94.01,0,0,0,,0,33,0,7,0,47,148,166,0,
476,Phil Watanabe,35,441,272,50,17,33,23,51,157,89.2,0,0,0,51.47,8,18,0,4,0,2,66,375,270,
477,Bob Madden,25,449,520,55,19,36,15,51,181,92.82,0,0,0,44.81,21,13,0,6,0,6,262,187,398,
478,Jack Kelly,24,333,335,54,18,36,10,51,171,95.0,1905,368,1537,53.13,16,9,0,4,0,0,165,168,331,Cutter
479,Peter Geertz-Larson,19,311,346,56,7,49,7,51,95,87.96,0,0,0,51.16,11,10,1,2,0,0,244,67,272,
480,Matt Parisi,47,830,995,95,48,47,11,51,528,91.19,0,0,0,46.03,43,48,0,7,0,0,615,215,851,
481,John Quandt,25,410,470,58,19,39,19,51,186,90.73,0,0,0,35.74,15,18,0,8,0,13,234,176,387,
482,Jack Shey,37,625,708,61,13,48,24,51,236,93.28,0,0,0,35.03,19,15,0,19,0,1,282,343,674,
483,Rhys Bergeron,21,363,281,36,20,16,27,51,133,91.1,1012,347,665,45.91,13,11,0,1,0,1,53,310,387,
484,Laurent Loiseau,27,508,579,75,19,56,13,51,176,84.21,0,0,0,42.14,17,25,1,12,0,0,299,209,455,
485,Sol Yanuck,24,502,508,72,54,18,14,51,913,95.5,6468,5260,1208,58.46,52,35,0,0,0,2,348,154,534,Handler
486,Max Guy,33,557,543,45,8,37,20,50,151,93.79,0,0,0,40.52,24,7,0,8,0,1,205,352,506,
487,Nathan Champoux,15,294,303,30,12,18,38,50,92,84.4,0,0,0,28.05,10,14,1,4,0,1,82,212,279,
488,Nate Bosscher,26,448,413,54,42,12,19,50,238,90.15,0,0,0,48.91,22,21,0,2,0,262,134,314,456,
489,Nick Zeman,38,586,489,50,19,31,20,50,130,87.25,0,0,0,31.7,9,15,1,5,0,2,117,469,572,
490,Matt Jaffe,54,905,663,57,33,24,31,49,452,92.81,328,169,159,39.37,27,32,1,7,0,361,117,788,792,
491,Jacob Greenberg,15,303,304,41,9,32,22,49,101,90.18,0,0,0,42.11,8,9,0,5,0,1,149,154,292,
492,Raynald Nemours,33,650,873,49,28,21,38,49,574,93.64,0,0,0,46.96,54,32,0,6,0,1,539,111,598,
493,William Vu,38,871,992,130,107,23,50,49,900,86.12,0,0,0,40.93,64,126,0,5,0,137,457,414,831,
494,Timmy Meyers,16,220,0,64,30,34,13,49,146,87.95,0,0,0,,0,20,0,8,0,0,119,101,0,
495,Alex Rummelhart,49,711,712,54,14,40,25,49,358,93.96,0,0,0,37.5,34,17,0,13,0,1,231,480,744,
496,Hans Rasmussen,34,367,122,73,23,50,10,49,239,93.73,0,0,0,53.28,4,25,0,9,0,1,182,185,86,
497,Connor Armstrong,30,614,814,69,31,38,13,49,833,95.64,0,0,0,51.47,49,32,1,1,0,0,552,62,559,Hybrid
498,Jordan McGregor,32,546,444,47,11,36,26,49,123,88.49,0,0,0,37.16,13,14,0,10,0,2,94,452,452,
499,Jake Herman,16,188,0,58,20,38,5,49,91,87.5,0,0,0,,0,13,0,1,0,0,110,78,0,
500,Brett Petersen,41,633,497,48,16,32,28,49,185,86.85,0,0,0,44.47,29,25,0,2,0,5,59,574,573,
501,Michael Neve,24,397,455,51,20,31,13,49,220,95.65,0,0,0,50.77,22,9,0,6,0,0,264,133,347,
502,Ryan Segal,20,324,438,54,13,41,7,49,129,92.81,0,0,0,45.43,14,7,0,5,0,0,301,23,304,
503,Lloyd Blake,28,609,822,83,54,29,19,48,871,93.86,0,0,0,47.93,62,50,0,4,0,1,491,118,612,Handler
504,Rumi Tejpar,22,457,531,65,33,32,22,48,323,88.98,0,0,0,46.52,35,35,0,4,0,39,293,164,430,
505,Paul Arters,9,187,204,51,29,22,4,48,181,95.77,3467,1962,1505,67.16,14,6,0,1,0,2,177,10,197,
506,Christian Mathieu,30,548,660,59,34,25,19,48,439,93.6,0,0,0,40.0,29,25,1,5,0,31,351,197,527,
507,Anders Olsen,36,661,600,79,21,58,15,48,298,87.65,0,0,0,42.0,28,36,1,10,0,0,247,414,602,
508,Mads Gottlieb,14,278,265,30,19,11,26,48,53,,0,0,0,38.49,3,8,0,0,0,5,44,234,213,
509,Joe Sefton,23,449,528,69,34,35,9,48,391,91.57,1569,1032,537,51.33,31,23,1,7,0,2,315,134,447,
510,Brett Hulsmeyer,21,399,276,23,6,17,35,48,141,94.0,1238,500,738,48.19,22,8,0,2,0,60,85,314,431,
511,Javier Ortiz,48,861,751,64,18,46,32,48,328,87.47,0,0,0,30.49,31,36,0,12,0,15,312,549,786,
512,Marcus Ranii-Dropcho,8,219,234,46,37,9,11,47,221,94.04,0,0,0,49.15,9,9,0,1,0,27,103,116,202,
513,Daniel Sperling,20,359,315,50,21,29,5,47,138,96.5,49,0,49,54.92,11,4,3,4,0,0,170,189,339,
514,Francois-Xavier Hotte,24,404,500,72,24,48,6,47,173,86.5,0,0,0,45.0,22,22,0,9,0,1,322,82,354,
515,Matt Russell,15,361,312,35,14,21,24,47,102,91.07,0,0,0,41.03,8,10,0,2,0,0,87,274,338,
516,Tommy Gallagher,31,623,757,70,33,37,12,47,962,95.82,323,147,176,51.92,65,31,0,4,0,0,491,132,654,Handler
517,Greg Slover,24,469,250,70,34,36,13,47,304,90.75,0,0,0,43.6,11,27,0,9,0,3,280,189,198,
518,Seth Weaver,27,504,338,46,30,16,19,47,320,94.12,1022,601,421,44.67,31,16,0,2,0,1,57,447,541,Handler
519,Patrick Kaufmann,16,277,320,41,7,34,21,47,77,,0,0,0,38.75,9,5,0,10,0,41,85,192,305,
520,Sun Choi,55,881,731,82,50,32,25,47,558,90.73,31,12,19,43.78,46,51,1,9,0,183,276,605,831,
521,Owen Watt,37,700,770,95,49,46,18,47,291,82.91,1252,552,700,40.78,29,55,1,11,0,10,404,296,726,
522,Colin Grandon,55,1099,1107,104,49,55,31,46,507,85.79,0,0,0,32.34,34,76,0,13,0,64,476,623,1005,
523,Brayden Gee,21,407,398,55,15,40,12,46,126,86.9,0,0,0,40.2,12,16,0,5,0,1,174,233,391,
524,Fred Lam,25,562,515,43,16,27,35,46,211,88.66,0,0,0,34.95,20,25,0,7,0,128,201,361,516,
525,Troy Holland,23,401,417,36,15,21,24,46,234,95.12,0,0,0,37.65,19,9,0,5,1,0,121,280,423,
526,Erik Hunter,46,753,647,68,31,37,23,46,251,82.57,188,125,63,38.02,17,40,4,5,0,225,201,552,660,
527,Jeremy Burril,34,499,544,69,26,43,7,46,284,91.91,2086,810,1276,55.15,37,22,1,8,0,1,356,143,513,
528,Simon Evans,23,388,322,40,2,38,14,46,30,,0,0,0,37.58,2,3,0,5,0,0,59,329,349,
529,Mitch Cihon,20,201,159,43,13,30,13,46,115,92.0,0,0,0,40.88,7,8,1,2,0,0,115,86,118,
530,Scott Xu,32,733,647,98,68,30,27,46,858,91.47,465,292,173,41.27,50,69,1,10,0,34,415,318,622,Handler
531,Matthew Knowles,45,684,545,50,44,6,20,46,459,94.06,389,279,110,46.97,30,23,1,1,1,9,194,490,720,Defender
532,Andrew Allen,21,307,240,28,8,20,25,46,61,,0,0,0,38.75,7,3,0,4,0,1,33,274,243,
533,Matt Cameron,12,268,357,56,12,44,5,45,182,93.81,0,0,0,39.78,17,11,0,5,0,0,242,26,274,
534,Unmil Patel,20,312,297,39,14,25,10,45,120,96.0,2101,504,1597,49.16,16,3,0,1,1,1,184,128,324,
535,Chris Calhoun,13,263,327,53,13,40,4,45,178,94.68,23,23,0,52.29,21,9,0,3,0,0,214,49,256,
536,Charles Bariteau,43,714,610,40,22,18,18,45,168,92.31,0,0,0,37.87,26,10,0,3,0,3,120,594,700,
537,David Shields,42,664,540,62,37,25,17,45,448,91.62,1703,1418,285,46.3,25,32,0,2,0,39,163,501,679,
538,Ian Guerin,34,304,295,30,11,19,26,45,80,,0,0,0,41.36,13,11,0,0,0,0,28,276,332,
539,John Kolb,23,353,204,48,25,23,17,45,215,91.1,0,0,0,48.04,12,19,0,1,0,90,115,238,187,
540,David Colic,19,344,435,68,24,44,8,45,129,85.43,1734,347,1387,51.95,12,22,0,9,1,0,289,55,368,
541,David Cranston,18,357,369,41,19,22,22,45,166,89.73,0,0,0,40.65,24,14,0,4,0,2,127,230,346,Defender
542,Glenn Poole,35,620,456,79,57,22,18,45,547,92.24,0,0,0,43.86,28,44,1,8,0,45,294,326,419,
543,Calum Mackenzie,12,200,0,50,29,21,10,45,150,95.54,0,0,0,,0,7,0,8,0,1,112,88,0,
544,Andrew Padula,52,825,558,40,8,32,27,44,240,93.39,646,278,368,41.94,28,16,0,7,0,1,64,761,763,Defender
545,Nicholas Simonelli,23,454,321,57,28,29,10,44,333,95.97,0,0,0,46.11,25,10,2,13,0,8,260,194,251,
546,Tommy Li,22,482,481,61,29,32,13,44,274,89.84,0,0,0,45.11,22,26,1,4,0,23,226,256,460,
547,Grant Zukowski,42,739,499,62,33,29,27,44,531,91.55,0,0,0,36.67,18,36,0,9,0,76,232,507,498,
548,Jacques Nissen,17,312,376,49,30,19,5,44,416,97.2,3569,1510,2059,62.77,31,8,1,2,0,0,296,16,347,
549,John Cecil,38,561,438,40,15,25,26,44,132,91.03,862,247,615,32.19,13,12,0,10,0,1,92,469,503,
550,Brian Zid,29,338,225,72,27,45,6,44,303,91.54,0,0,0,44.89,12,28,0,6,0,0,237,101,169,
551,Robbie Craven,21,242,55,31,8,23,22,44,50,,0,0,0,,1,4,0,5,0,43,11,231,56,
552,Benjamin Sadok,12,296,357,68,37,31,2,44,520,94.72,6634,3847,2787,58.26,37,25,1,1,0,0,294,2,309,
553,Simon Charette,32,504,496,38,5,33,16,43,127,91.37,373,125,248,48.19,25,10,0,1,0,0,225,279,492,
554,Vincent Lemieux,30,578,600,66,40,26,20,43,421,90.73,3735,2410,1325,43.33,25,33,1,10,0,6,320,258,586,
555,John Randolph,18,396,406,53,26,27,12,43,398,94.31,0,0,0,53.69,31,21,0,1,0,0,228,168,352,
556,Avery Van Brussel,17,400,474,53,20,33,9,43,175,93.09,0,0,0,49.79,12,11,0,8,0,12,281,119,377,
557,Chris Kocher,15,331,348,54,38,16,7,43,417,94.77,0,0,0,49.43,35,18,1,0,0,5,194,137,304,
558,Steven Brooks,31,675,855,75,42,33,1,43,855,95.85,0,0,0,51.93,43,25,0,8,0,0,635,40,642,
559,Brian Kragt,13,119,0,56,27,29,12,43,138,92.62,0,0,0,,0,22,0,3,0,0,58,61,0,
560,Munis Thahir,22,438,428,51,17,34,9,43,159,94.08,1573,308,1265,47.9,14,8,0,9,0,0,262,176,441,
561,Kevin Smith,57,1193,1339,159,136,23,31,43,1046,86.8,0,0,0,46.6,66,138,0,9,0,85,687,506,1114,
562,Alex Krzywda,21,211,0,51,25,26,12,43,185,94.39,0,0,0,,0,15,0,5,0,0,148,63,0,
563,Joe Merrill,11,146,173,43,4,39,3,43,69,,1789,44,1745,60.12,6,3,0,0,0,0,133,13,183,
564,Matthew Glazer,24,310,165,71,28,43,7,42,220,90.53,1617,469,1148,49.7,13,23,0,13,0,0,218,92,155,Cutter
565,Jordan Kerr,11,279,322,52,25,27,13,42,289,92.63,4890,2868,2022,49.07,21,18,0,5,0,0,241,38,280,
566,Jack Marsh,16,293,251,88,50,38,10,42,271,84.69,0,0,0,43.82,16,47,0,9,0,8,230,63,176,
567,Patrick Lindsey,24,255,190,33,6,27,22,42,77,,0,0,0,29.47,4,9,0,4,0,0,128,127,176,
568,Sam Kanner,22,478,525,63,41,22,17,42,250,85.91,0,0,0,43.62,22,36,1,2,0,230,144,334,462,
569,Jason Vallee,23,375,248,41,25,16,15,42,183,94.82,1205,511,694,45.16,11,7,0,7,0,10,39,336,415,
570,Lucky Mosola,26,354,265,29,10,19,23,42,72,,0,0,0,36.6,8,6,0,4,0,0,50,304,288,
571,David Bloodgood,38,764,635,63,44,19,35,42,687,91.36,1431,1316,115,41.89,53,50,0,6,0,162,150,614,811,
572,Griffin Miller,28,375,315,32,12,20,20,42,97,93.27,506,45,461,40.0,7,7,0,3,0,0,73,302,382,
573,Ben Feng,27,560,498,48,26,22,29,42,283,90.13,0,0,0,38.15,24,27,1,8,0,6,154,406,531,
574,Chris Gibson,34,651,724,65,31,34,9,42,315,91.3,0,0,0,52.21,47,26,0,6,0,0,438,213,627,
575,Mason Gardner,24,450,387,25,6,19,38,42,154,90.59,0,0,0,31.27,8,16,1,5,0,262,109,341,469,
576,Jordan Jeffery,24,543,565,65,39,26,24,41,371,88.76,0,0,0,40.0,25,44,0,4,0,166,239,304,502,Handler
577,Phil Dougherty,45,848,656,48,31,17,30,41,319,89.86,0,0,0,31.25,19,28,1,9,0,114,228,620,765,
578,Alex Henderson,21,382,443,54,27,27,12,41,417,94.13,0,0,0,54.18,40,23,0,2,0,12,263,119,404,
579,Tim Lavis,13,323,412,59,37,22,8,41,214,87.7,0,0,0,44.17,15,20,0,6,0,2,233,90,282,
580,Matthew Bierschenk,30,452,469,67,36,31,7,41,176,83.81,0,0,0,45.42,16,28,0,5,0,18,257,195,391,Cutter
581,Alex Drlica-Wagner,38,498,503,32,11,21,21,41,225,95.74,0,0,0,37.57,7,7,0,5,0,1,136,362,491,
582,Andy Corey,24,542,558,78,50,28,18,41,282,82.94,0,0,0,40.5,21,48,0,7,0,299,195,347,489,
583,Kevin Willis Ryan,14,132,0,52,23,29,8,41,114,90.48,0,0,0,,0,12,0,7,0,0,61,71,0,
584,Logan Rhyne,13,287,348,56,29,27,6,41,151,89.35,0,0,0,49.43,22,17,0,4,0,34,220,67,296,
585,Carter Rae,34,576,470,67,46,21,17,41,300,86.71,1209,983,226,45.32,27,41,0,2,0,16,203,373,543,
586,Marcel Osborne,27,456,415,50,17,33,9,41,159,91.38,1936,540,1396,45.06,23,11,0,7,0,9,183,273,505,Cutter
587,Dennis Tarasi,12,286,384,53,34,19,11,41,345,93.24,0,0,0,50.26,36,19,0,4,0,0,241,45,264,
588,Tyler Kunsa,39,890,1132,92,63,29,14,41,1534,95.58,1125,748,377,50.35,95,62,0,3,0,1,757,133,949,Handler
589,Danny Collom,40,919,1073,101,74,27,35,41,913,88.47,0,0,0,36.81,79,86,1,9,0,11,362,557,929,
590,Matthew Armour,35,508,398,44,20,24,14,41,190,91.79,2148,830,1318,45.73,18,16,0,1,0,0,108,400,487,
591,Robert Bradham,39,594,405,53,17,36,13,41,106,84.13,0,0,0,36.54,8,17,0,8,0,0,72,522,481,
592,Ryan Nam,15,292,317,48,26,22,12,40,254,92.7,0,0,0,41.96,15,17,1,3,1,4,154,138,276,
593,Jordan Taylor,34,522,531,52,20,32,22,40,219,87.25,1019,389,630,43.13,22,28,0,6,0,122,187,335,564,Defender
594,Clay Miller,41,801,774,47,28,19,23,40,624,96.15,0,0,0,41.99,39,18,3,12,0,4,234,567,725,
595,Michael Hays,19,371,379,40,12,28,15,40,107,86.99,0,0,0,38.79,7,13,0,2,0,2,121,250,334,
596,Alex Duffel,41,890,941,70,36,34,19,40,788,94.37,0,0,0,47.29,57,40,0,9,0,0,512,378,823,
597,Jacob Bartholomew,21,353,272,34,4,30,12,40,55,,0,0,0,40.44,9,5,0,1,0,1,60,293,299,
598,Tim Ryan,15,190,112,53,14,39,9,40,147,90.74,0,0,0,49.11,9,15,0,7,0,0,156,34,90,
599,Kevin Horgan,23,222,128,33,9,24,14,40,106,97.25,0,0,0,50.78,9,3,0,4,0,3,96,126,98,
600,Christo Ferguson,17,209,0,71,30,41,7,40,320,94.96,0,0,0,,0,31,0,7,0,1,64,145,0,
601,Sam Harkness,24,432,358,43,20,23,12,40,169,92.35,0,0,0,44.13,13,12,1,3,0,0,100,332,406,
602,Andy Cava,34,689,929,93,69,24,8,40,1204,94.73,0,0,0,46.61,57,54,0,7,0,1,579,110,700,
603,Kevin Riechert,15,154,0,45,27,18,11,40,139,90.26,0,0,0,,0,15,0,1,0,0,72,82,0,
604,Akifumi Muraoka,14,302,373,57,30,27,6,40,207,88.46,0,0,0,52.28,25,23,0,0,0,0,249,53,305,
605,Mark Poole,18,382,450,50,29,21,9,40,362,96.02,0,0,0,55.11,34,14,0,5,0,37,303,79,330,
606,Steven Hicks,22,347,392,51,24,27,9,40,290,92.95,0,0,0,54.08,21,19,1,1,0,34,253,94,309,
607,Ryan Archibald,30,464,340,34,17,17,14,40,64,,0,0,0,35.29,8,7,0,1,0,0,52,412,399,
608,David Brandolph,32,504,29,140,113,27,15,40,792,88.49,0,0,0,,0,103,0,12,0,5,334,170,22,
609,Harper Garvey,43,1003,1322,161,147,14,15,40,1801,92.69,0,0,0,50.83,125,129,6,7,0,16,889,114,1077,Handler
610,Mike Reeves,21,278,99,40,16,24,15,39,103,88.79,0,0,0,,4,12,0,4,0,16,107,171,96,
611,Jonny Malks,16,263,320,62,41,21,3,39,676,95.89,5128,3916,1212,60.31,36,24,0,2,0,0,246,17,308,
612,Kevin Greer,23,447,445,56,30,26,13,39,168,82.76,0,0,0,39.55,28,26,0,4,0,1,227,220,417,
613,Russ Nicolls,22,383,438,48,18,30,12,39,192,89.3,0,0,0,44.75,26,18,0,3,0,0,220,163,340,
614,Eric Taylor,19,435,461,71,54,17,9,39,695,94.82,3214,1476,1738,59.22,50,36,0,5,0,62,320,115,474,Handler
615,Matthew Natali,24,355,291,34,14,20,12,39,91,,0,0,0,45.7,10,7,0,0,0,3,20,335,305,
616,Karl Ekwurtzel,23,328,314,42,12,30,9,39,163,94.22,2515,590,1925,49.68,19,10,0,2,0,0,168,160,377,
617,Cole Jurek,19,357,406,53,23,30,7,39,246,94.25,3925,1129,2796,51.97,25,13,1,8,0,0,259,98,366,Defender
618,Channing Watson,29,642,842,87,30,57,14,39,603,90.81,0,0,0,34.92,36,47,0,15,0,48,488,154,670,Cutter
619,Markian Kuzmowycz,16,290,411,61,19,42,9,39,210,87.87,0,0,0,46.47,22,28,0,3,0,0,269,21,299,
620,Josh Turner,25,379,355,40,21,19,11,39,265,94.31,0,0,0,50.7,18,10,0,2,0,12,201,178,366,Defender
621,Andrew Lucarotti,57,943,958,128,100,28,29,39,1258,92.03,0,0,0,34.97,38,101,0,17,0,0,745,198,718,
622,Chris Elworth,18,124,59,30,6,24,16,39,59,,0,0,0,,2,5,0,2,0,1,19,105,62,
623,Joel Bellavance,31,707,829,104,73,31,8,39,904,92.06,0,0,0,45.6,76,62,2,11,0,9,499,208,656,
624,Greg Owens,14,117,0,36,25,11,19,39,82,,0,0,0,,0,12,0,4,0,0,52,65,0,
625,Wilkie Lewis,16,322,368,44,18,26,6,39,113,91.87,1528,469,1059,52.17,14,9,0,2,0,0,261,61,299,
626,Ethan Downs,7,190,217,46,13,33,4,39,86,,0,0,0,44.24,9,8,0,3,0,0,141,49,163,
627,Nico Lake,28,511,650,59,31,28,6,39,714,95.58,2508,1783,725,47.38,48,22,0,4,0,0,420,91,524,
628,Jon Staron,27,528,322,62,30,32,16,39,984,95.81,0,0,0,49.69,37,29,1,10,0,0,435,93,249,
629,Michael Shiel,17,294,427,52,37,15,13,39,384,92.98,0,0,0,39.58,21,22,0,4,0,8,223,71,359,
630,Jarrod Banks,11,193,227,49,21,28,4,39,122,91.04,0,0,0,62.11,13,9,0,5,0,0,154,39,191,
631,Alex Davis,30,614,492,24,7,17,33,39,136,89.47,0,0,0,34.96,12,15,1,3,0,5,182,432,524,Cutter
632,Russell Wynne,14,297,328,33,17,16,23,39,256,93.43,0,0,0,35.37,14,17,0,0,0,87,97,200,346,
633,Eric Greenwood,16,287,360,56,22,34,8,38,147,84.97,0,0,0,40.0,22,21,0,5,0,3,142,145,273,
634,Ryan Holmes,47,593,415,39,19,20,26,38,75,74.26,318,36,282,39.76,6,25,1,2,0,359,46,547,589,Defender
635,Keith Garner,21,324,314,37,25,12,11,38,188,92.61,0,0,0,49.68,25,10,1,0,0,80,42,282,326,
636,Kenrick Koo,14,283,267,44,25,19,11,38,202,92.66,2292,1219,1073,50.56,16,12,1,5,0,19,139,144,319,Defender
637,Brian Moore,11,279,343,46,21,25,4,38,191,94.09,0,0,0,54.23,24,9,0,3,0,1,242,37,251,
638,Tyler Glenn,11,210,0,31,13,18,28,38,122,89.05,0,0,0,,0,15,0,6,0,74,69,141,0,
639,Josiah Mort,26,415,295,31,13,18,19,38,72,,0,0,0,38.31,10,11,0,1,0,12,58,357,341,
640,Michael Burke,16,243,325,49,18,31,15,38,89,78.76,0,0,0,36.62,7,21,0,5,0,3,194,49,247,Cutter
641,Stève Bonneau,34,676,927,125,108,17,15,38,1079,89.92,0,0,0,43.8,54,96,0,6,0,27,548,128,709,Handler
642,Alex Drum,26,381,258,32,15,17,16,38,98,89.91,0,0,0,41.86,12,7,0,3,0,1,49,332,357,
643,Marcus Thaw,33,551,493,43,21,22,20,38,277,92.03,0,0,0,40.37,24,22,0,3,0,36,137,414,492,
644,Liam Bradford,41,545,455,51,15,36,15,38,254,90.07,0,0,0,55.6,32,24,0,4,0,4,273,272,355,
645,Alec Surmani,23,383,453,45,16,29,9,37,248,93.58,0,0,0,47.24,11,15,1,2,0,3,255,128,336,
646,Quinn Snider,5,126,146,35,6,29,4,37,47,,0,0,0,59.59,10,2,0,0,0,0,96,30,113,Cutter
647,Vinay Valsaraj,12,250,311,48,21,27,12,37,167,90.27,3319,878,2441,46.62,13,16,0,7,0,0,216,34,265,
648,Kane Olson,37,580,296,80,47,33,40,37,556,90.26,0,0,0,38.18,10,67,1,16,0,12,380,200,215,
649,Matt Gouchoe-Hanas,14,285,339,47,27,20,0,37,608,98.54,3810,3458,352,64.9,40,7,1,3,0,0,285,0,300,Handler
650,James Pollard,28,407,329,38,19,19,25,37,123,83.11,1679,891,788,32.83,7,21,0,5,0,218,99,308,374,
651,Andrew Hagen,22,460,421,25,11,14,37,37,154,87.5,0,0,0,43.71,20,21,0,4,0,6,106,354,428,
652,Neal Hanke,25,385,281,30,14,16,29,37,158,88.76,0,0,0,34.88,12,19,1,3,0,54,130,255,257,
653,Quinn Bergeron,31,438,315,29,6,23,24,36,100,85.47,570,143,427,42.86,10,16,0,1,0,2,51,387,458,
654,Charlie Furse,37,459,381,44,14,30,10,36,183,91.5,961,367,594,39.37,11,14,1,4,0,0,68,391,534,
655,Ben Rogers,33,406,307,26,8,18,15,36,107,97.27,664,246,418,38.44,9,3,0,2,0,0,54,352,390,
656,Michael Ames,86,1646,1701,163,119,44,21,36,2310,93.6,669,471,198,46.27,121,127,5,21,0,25,1210,436,1363,Handler
657,Myles Sinclair,22,487,454,53,33,20,17,36,373,90.53,0,0,0,40.53,17,29,0,5,0,201,187,300,446,
658,Jakob Brissette,16,274,303,51,40,11,10,36,388,93.05,3543,3007,536,49.5,21,20,0,5,0,5,194,80,305,
659,David Hampson,26,496,429,70,27,43,18,36,597,92.13,0,0,0,36.36,26,43,0,9,0,5,367,129,369,
660,Zack Travis,14,287,336,35,11,24,14,36,112,88.89,0,0,0,41.37,8,10,0,3,1,0,127,160,291,
661,Duncan Linn,24,486,407,35,20,15,22,36,190,89.62,0,0,0,42.75,20,18,0,3,0,21,101,385,456,
662,Andrew Cohen,24,461,615,50,35,15,11,36,662,95.53,1570,897,673,44.88,35,23,0,2,0,3,392,69,519,
663,Kip Curtis,19,332,264,28,11,17,15,36,67,,0,0,0,40.91,9,4,0,3,0,1,50,282,287,
664,Nathan Dandurand,15,237,247,27,8,19,16,36,88,,0,0,0,37.25,9,7,0,0,0,0,50,187,242,
665,Ethan Rasmussen,34,636,799,76,46,30,20,36,522,90.16,0,0,0,42.18,45,49,0,11,0,39,420,216,601,Cutter
666,Kyle Silva,19,266,297,35,4,31,15,36,86,,0,0,0,36.36,8,10,2,4,0,0,166,100,249,
667,Mark Slader,35,540,371,42,17,25,19,36,231,91.3,0,0,0,43.67,16,20,0,5,0,285,93,447,480,
668,Matt Costello,17,365,431,46,26,20,8,36,229,93.09,0,0,0,53.6,12,13,0,5,0,3,236,129,328,
669,KJ Dziak,25,327,262,92,68,24,17,36,445,88.82,0,0,0,32.06,15,66,0,7,0,0,257,70,195,
670,Tim Fergus,29,532,754,85,54,31,11,35,1014,94.86,0,0,0,45.76,67,48,0,13,0,0,448,84,615,
671,Eric Blanchard,22,219,75,34,10,24,8,35,61,,0,0,0,,4,3,0,4,0,0,50,169,76,
672,Evan Swiatek,10,234,276,53,14,39,8,35,207,90.39,3642,882,2760,49.28,17,21,0,5,0,0,177,57,272,
673,Isaac Julien,14,243,0,34,12,22,12,35,98,94.23,0,0,0,,0,6,0,5,0,10,186,57,0,
674,Reed Hendrickson,11,205,229,37,7,30,9,35,80,,0,0,0,50.66,17,8,0,3,0,0,132,73,193,Cutter
675,Malcolm Bryson,16,348,278,39,25,14,14,35,235,93.25,0,0,0,41.73,19,15,0,3,0,0,116,232,291,
676,Tate Halberg,15,325,422,64,21,43,5,35,201,86.27,0,0,0,36.49,25,28,0,6,0,1,274,51,323,Cutter
677,Joshua Zdrodowski,18,278,265,38,15,23,12,35,89,88.12,0,0,0,36.6,7,10,0,5,0,55,97,181,257,
678,Jeffrey Walker,26,389,319,26,6,20,17,35,78,,0,0,0,34.8,6,4,0,4,0,249,92,297,344,
679,Aldous Root,13,301,360,42,18,24,8,35,177,93.16,0,0,0,41.39,19,12,0,3,0,0,209,92,303,
680,Ben Sage,25,290,39,41,19,22,18,35,215,92.27,0,0,0,,0,18,0,6,0,24,151,139,40,
681,David Hochhalter,26,485,151,147,102,45,18,35,810,91.84,0,0,0,40.4,11,106,0,24,0,35,185,300,135,
682,Joshua Shepard,35,387,69,48,20,28,16,35,241,94.51,0,0,0,,1,25,0,4,0,13,96,291,77,
683,Ari Weitzman,13,114,35,32,9,23,12,35,76,,0,0,0,,0,8,0,1,0,12,51,63,38,
684,Bob Liu,55,1139,1325,124,87,37,25,35,2147,94.62,0,0,0,48.83,109,104,0,10,0,38,896,243,1084,Handler
685,Jack Brown,19,336,355,42,11,31,14,34,174,92.06,2483,430,2053,43.38,14,13,0,9,0,2,230,106,346,Cutter
686,Adam Carr,21,497,434,41,20,21,13,34,538,95.22,0,0,0,43.55,45,20,0,0,0,10,185,312,513,
687,Brendan McCann,26,574,400,45,26,19,19,34,348,90.16,1191,726,465,40.25,25,30,1,0,0,128,127,447,510,Handler
688,Dan Vockeroth,31,406,363,33,6,27,17,34,126,94.03,0,0,0,38.02,11,6,0,10,0,115,114,292,365,
689,Dillon Tranquillo,19,272,223,12,1,11,25,34,14,,0,0,0,40.81,4,1,0,2,0,1,21,251,228,Defender
690,Sam Plasman,33,401,263,30,5,25,12,34,57,,284,60,224,49.81,7,6,0,2,0,0,42,359,351,Defender
691,Jason Holleran,36,510,449,35,12,23,15,34,228,91.2,0,0,0,39.87,23,15,0,1,0,35,159,351,438,
692,Willie Stewart,12,277,296,38,25,13,7,34,243,94.92,3301,1960,1341,55.41,23,11,0,0,0,16,223,54,287,
693,Elijah Long,14,263,167,35,23,12,8,34,264,95.65,2017,1471,546,62.87,29,9,0,0,0,1,35,228,305,Handler
694,Graham Landon,14,261,259,36,17,19,18,34,130,88.44,0,0,0,40.54,14,16,0,4,0,53,56,205,218,
695,Dan Bellinger,39,729,597,65,52,13,23,34,471,88.7,0,0,0,38.19,35,51,0,3,0,529,135,594,708,
696,Taylor Goforth,27,384,315,26,17,9,26,34,100,83.33,0,0,0,32.7,7,17,0,1,0,18,76,308,343,
697,Colin Ringwood,68,902,689,56,19,37,23,34,326,88.11,551,470,81,34.98,22,36,1,9,0,18,99,803,846,
698,Tony Poletto,35,718,874,83,60,23,9,33,1328,95.95,2316,2114,202,55.26,81,52,1,7,0,5,584,134,701,Handler
699,Kinley Gee,32,723,936,92,59,33,11,33,1064,93.25,0,0,0,44.98,88,63,3,7,0,4,594,129,695,Handler
700,Zac Merie,19,266,324,32,3,29,10,33,85,,0,0,0,42.28,7,5,0,4,0,0,163,103,244,Cutter
701,Hayden Stone,12,272,324,38,22,16,5,33,170,93.41,2483,899,1584,48.15,11,8,0,2,0,1,243,29,277,
702,Christopher Sackmann,20,199,93,24,5,19,17,33,59,,0,0,0,,2,7,0,1,0,0,61,138,111,
703,Kyle Romard,25,477,485,45,11,34,6,33,212,93.39,2958,796,2162,41.65,25,14,1,4,0,65,289,188,445,
704,Justin Lim,13,300,379,49,21,28,5,33,221,90.57,0,0,0,52.77,16,21,1,0,0,3,239,61,274,
705,Mark Flores,14,201,298,42,19,23,8,33,118,90.77,0,0,0,40.94,13,12,1,5,0,0,175,26,233,
706,Henry Phan,17,398,449,54,37,17,11,33,607,94.84,0,0,0,49.44,43,27,1,5,0,1,271,127,401,
707,Adrian Reif,30,406,118,30,17,13,15,33,142,95.3,0,0,0,36.44,6,6,1,6,0,2,83,323,153,
708,Ron Kubalanza,22,427,322,52,34,18,5,33,565,95.76,0,0,0,47.2,24,21,0,3,0,1,313,114,260,
709,Sam Chatterton-Kirchmeier,15,223,266,36,18,18,9,33,170,91.4,0,0,0,43.23,11,11,1,1,0,3,124,99,211,
710,Justin Foord,10,193,176,22,6,16,22,33,84,,0,0,0,40.91,9,8,0,3,0,29,46,147,193,
711,Dana Granholm,23,337,299,35,9,26,7,32,117,90.7,0,0,0,41.81,10,9,1,1,0,24,49,288,311,
712,Robert Runner,25,554,497,47,31,16,29,32,459,90.18,0,0,0,37.63,34,43,1,1,0,188,111,443,541,
713,Joe Babbino,33,372,249,42,11,31,15,32,137,87.82,0,0,0,41.77,12,18,1,7,0,85,80,292,233,
714,Alan Huels,26,449,201,20,5,15,21,32,53,,0,0,0,28.86,3,7,0,2,0,261,82,367,259,
715,John Paul Taylor,13,257,249,36,5,31,6,32,72,,0,0,0,49.0,10,8,0,2,0,0,146,111,252,Cutter
716,Joey Wylie,12,254,211,32,15,17,13,32,111,89.52,2226,551,1675,48.82,9,11,0,2,0,0,67,187,267,
717,John Wodatch,17,442,463,54,30,24,12,32,302,90.15,309,111,198,43.84,17,28,1,6,0,145,225,217,441,
718,Jake Gutkowski,19,307,383,43,17,26,7,32,344,96.9,0,0,0,53.0,17,11,0,7,0,1,257,50,292,
719,Evan Howey,38,670,603,55,23,32,18,32,381,89.44,52,5,47,34.16,31,33,0,8,0,42,226,444,640,
720,Mac Taylor,9,239,304,54,30,24,3,32,161,85.64,0,0,0,56.91,23,23,0,2,0,1,214,25,194,
721,Carson Turner,39,745,576,40,23,17,34,32,298,86.13,1234,626,608,34.03,23,37,0,5,0,176,153,592,716,
722,Art Shull,15,158,0,46,19,27,12,32,117,86.67,0,0,0,,0,18,0,8,0,0,70,88,0,
723,William Coffin,23,486,595,47,18,29,17,32,308,91.12,0,0,0,46.72,31,26,0,6,0,41,376,110,466,
724,Sachin Raina,48,802,798,66,39,27,22,32,1053,95.21,0,0,0,54.01,39,48,0,8,0,15,604,198,563,
725,Lance Blackstock,17,288,230,29,11,18,12,31,57,,0,0,0,36.96,4,6,0,4,0,31,35,253,240,Defender
726,Geoff Serednesky,16,268,358,35,12,23,12,31,166,90.71,0,0,0,33.52,16,11,0,5,0,30,180,88,293,
727,Chris Graber,25,385,326,37,7,30,3,31,77,,365,12,353,42.94,7,7,0,2,0,0,133,252,397,
728,Rami Paust,15,264,324,58,42,16,7,31,371,92.29,4910,2659,2251,50.62,29,28,2,6,0,1,232,32,277,
729,Mason Wuensch,19,272,187,21,3,18,19,31,55,,726,74,652,46.52,5,6,0,3,0,3,23,249,294,
730,Albert Alarcon,22,306,129,38,20,18,12,31,175,93.09,0,0,0,42.64,7,13,0,6,0,3,88,218,184,Cutter
731,Benjamin Oort,10,162,209,35,4,31,5,31,55,,0,0,0,50.24,9,6,1,3,0,0,134,28,141,
732,Nicky Spiva,20,504,572,79,71,8,25,31,592,88.36,0,0,0,41.96,49,72,2,1,1,80,245,259,495,
733,Jake Kenniv,10,221,267,35,10,25,8,31,119,90.84,2624,488,2136,37.45,13,11,0,1,0,3,197,24,247,
734,Rocco Linehan,11,190,239,45,26,19,5,31,205,92.34,3193,1413,1780,54.39,11,15,1,4,0,12,150,40,210,
735,Eliot Bemis,33,347,259,39,5,34,10,31,128,90.78,0,0,0,40.93,7,13,0,5,0,0,221,126,213,
736,Shawn St-Jean Timmins,29,463,530,61,28,33,6,31,211,84.74,0,0,0,42.08,24,27,0,9,0,2,315,148,422,
737,Ty Barbieri,13,243,287,44,9,35,11,31,81,,0,0,0,39.72,11,13,0,11,0,6,168,75,224,
738,Zach Riggins,28,343,269,24,12,12,15,31,106,95.5,0,0,0,42.38,6,3,0,5,0,25,31,312,285,Defender
739,Casey Hogg,34,413,414,31,11,20,16,30,188,92.16,0,0,0,46.62,18,15,0,2,0,26,152,261,363,
740,Tad Wissel,23,416,361,45,34,11,7,30,483,94.52,0,0,0,55.68,34,21,0,1,0,5,124,292,345,
741,Matt Rybak,21,514,580,67,32,35,9,30,431,91.12,0,0,0,34.31,31,35,0,11,0,1,327,187,503,
742,Walden Nelson,11,198,275,23,6,17,8,30,139,99.29,0,0,0,39.27,11,1,0,0,0,1,105,93,250,
743,Walter Kasprzycki,29,510,370,33,17,16,17,30,101,86.32,289,83,206,32.97,8,15,0,5,0,206,56,454,483,
744,JD Hastings,27,407,289,35,20,15,8,30,205,93.61,0,0,0,44.29,20,11,1,2,0,0,38,369,386,
745,Colin Masino,28,383,249,13,5,8,27,30,87,,557,182,375,32.53,3,6,0,4,0,7,48,335,373,Cutter
746,Topher Davis,5,100,118,35,15,20,1,30,63,,1604,589,1015,64.41,5,3,0,3,0,0,100,0,100,
747,Luke Broderick,23,353,197,36,28,8,20,30,208,88.51,0,0,0,31.47,7,25,0,1,0,18,62,291,215,
748,Zack Smith,51,786,447,71,38,33,27,30,421,88.82,192,132,60,37.81,16,61,0,7,0,4,185,601,535,Handler
749,Jeffrey Robinson,32,388,302,35,20,15,23,30,310,92.54,855,632,223,40.4,21,24,0,4,0,182,50,338,408,
750,Jason Yoder,42,566,253,58,51,7,27,30,477,91.73,0,0,0,37.94,12,48,0,7,0,74,126,440,295,
751,Tommy Adams,35,473,330,26,6,20,15,30,94,94.0,0,0,0,38.79,14,6,0,5,0,0,66,407,411,Defender
752,Kyle Rubin,42,666,507,40,16,24,11,30,270,93.43,1446,631,815,45.76,39,15,0,6,0,0,204,462,640,
753,Bryant Dean,19,308,341,40,17,23,15,30,162,87.57,0,0,0,37.24,18,21,0,4,0,1,164,144,297,
754,Nate Pettyjohn,10,164,189,35,8,27,4,30,60,,1752,440,1312,53.44,6,5,0,4,0,1,135,29,177,Cutter
755,Andy Curtis,12,272,360,52,36,16,7,30,317,91.62,0,0,0,47.5,20,25,0,4,0,0,232,40,280,
756,Ray Davenport,11,214,298,47,28,19,6,30,169,90.37,0,0,0,48.99,24,17,0,6,0,0,192,22,201,
757,Mathew Ladyman,9,187,242,32,14,18,2,30,113,97.41,0,0,0,56.2,5,0,0,4,0,0,160,27,197,Cutter
758,James Sykora,44,605,527,39,19,20,23,30,239,89.18,314,160,154,40.04,23,26,0,6,0,241,153,452,612,
759,Pat Hammonds,30,491,493,59,33,26,11,30,278,88.25,0,0,0,43.2,23,35,1,5,0,140,210,281,437,
760,Billy Sickles,7,143,206,31,17,14,9,29,144,91.72,0,0,0,40.29,11,8,0,3,0,0,115,28,174,Cutter
761,Chip Cobb,23,267,237,41,14,27,16,29,121,84.03,0,0,0,38.82,8,20,3,8,0,5,118,149,209,
762,John Agan,23,333,278,25,8,17,10,29,98,94.23,0,0,0,46.76,8,5,0,1,0,1,58,275,319,
763,Jay Clark,10,221,280,45,19,26,8,29,224,90.69,0,0,0,49.64,22,19,0,5,0,14,188,33,211,
764,Sam Swink,39,797,952,50,25,25,9,29,797,96.26,0,0,0,49.26,41,23,2,7,0,3,543,254,741,
765,Eli Janin,24,491,663,80,71,9,13,29,782,91.14,0,0,0,47.06,49,63,0,1,0,32,380,111,499,
766,Matthew Berg,15,255,267,30,5,25,6,29,45,,0,0,0,40.45,8,2,0,5,0,0,122,133,220,
767,Taylor Minch,31,520,420,49,29,20,10,29,250,88.97,0,0,0,40.24,25,24,1,6,0,94,181,339,516,
768,Alex Davis,15,220,125,18,5,13,15,29,38,,931,196,735,57.6,6,2,0,2,0,0,4,216,256,Cutter
769,Sean Kelley,22,294,228,24,8,16,12,29,63,,0,0,0,35.09,3,5,0,2,0,1,70,224,276,
770,Ken Porter,25,370,293,45,26,19,19,29,163,83.59,0,0,0,38.23,8,29,0,6,0,2,180,190,283,
771,Henry Furuta,31,519,578,46,22,24,4,29,691,97.19,1165,1014,151,52.08,45,17,0,4,0,0,385,134,537,
772,Michael Cavanaugh,19,281,275,38,20,18,9,29,121,86.43,0,0,0,40.0,7,17,0,1,0,3,110,171,272,
773,Leon Chou,13,89,0,30,22,8,24,29,167,90.27,0,0,0,,0,18,0,7,0,0,56,33,0,
774,Ben Feldman,47,665,392,76,59,17,42,29,371,82.44,0,0,0,43.11,21,74,0,15,1,10,121,544,401,Hybrid
775,Chris Vandervoort,18,299,257,27,18,9,12,29,160,94.67,0,0,0,42.8,12,9,0,1,0,49,57,242,287,
776,Michael Baer,13,80,15,19,8,11,16,29,60,,0,0,0,,0,6,0,0,0,0,30,50,19,
777,Will Chen,31,608,629,37,22,15,19,29,432,93.91,0,0,0,52.62,27,24,0,3,0,9,324,284,567,
778,Evan Feeney,8,188,0,41,21,20,8,29,148,92.5,0,0,0,,0,12,0,8,0,0,147,41,0,
779,Anthony Sapichino,14,194,0,34,1,33,13,29,74,,0,0,0,,0,8,0,10,0,0,76,118,0,
780,Nabil Chaouch,20,334,293,28,8,20,14,29,63,,1117,230,887,38.57,4,8,0,5,0,0,138,196,315,
781,Ryan Sun,16,224,275,34,5,29,5,29,43,,0,0,0,49.09,5,7,1,3,0,0,168,56,174,
782,Allen Lai,44,909,1173,70,49,21,7,29,1597,96.5,0,0,0,50.72,97,46,1,2,0,4,847,62,913,
783,Bryan Sansbury,13,243,232,28,7,21,9,28,68,,0,0,0,37.07,14,7,0,2,0,0,107,136,208,
784,Dan Chazin,10,263,364,34,22,12,7,28,353,94.89,0,0,0,42.86,21,13,1,0,0,0,236,27,251,
785,Jeff Kula,31,608,463,59,38,21,22,28,1058,95.06,0,0,0,39.74,30,50,0,3,1,0,519,89,327,
786,John Doherty,25,390,259,24,5,19,19,28,50,,0,0,0,44.02,4,12,0,3,0,102,38,352,322,Defender
787,Carl Morgenstern,15,259,220,22,9,13,16,28,76,,0,0,0,38.18,6,7,0,3,0,0,43,216,225,
788,Marc Leduc,13,255,208,27,8,19,10,28,69,,0,0,0,38.46,11,6,0,3,0,6,87,168,208,
789,Ryan Brown,33,436,395,38,9,29,13,28,124,87.32,0,0,0,42.28,12,14,0,9,0,2,165,271,366,Cutter
790,Kelsen Alexander,40,558,412,49,23,26,16,28,474,93.86,0,0,0,48.79,30,29,2,8,0,2,168,390,391,
791,Ben Blatz,21,235,126,44,17,27,17,28,199,94.76,0,0,0,26.19,3,24,0,9,0,0,62,173,135,
792,Henry Babcock,11,247,297,42,29,13,2,28,373,95.64,4181,2805,1376,57.58,24,15,0,1,0,0,244,3,255,
793,Brandon Pastor,25,266,269,29,7,22,5,28,102,93.58,1053,163,890,47.58,8,5,0,1,0,0,153,113,282,Cutter
794,Matt Michelson,13,232,233,31,15,16,11,28,41,,0,0,0,33.91,9,12,0,2,0,132,87,145,235,
795,Joe Becker,21,285,167,47,18,29,7,28,87,82.08,0,0,0,29.34,0,19,0,7,0,2,227,58,114,
796,Monte Jones,18,223,270,30,2,28,8,28,76,,0,0,0,27.41,6,7,0,3,0,0,180,43,186,
797,Scott O'Brien,12,144,0,24,10,14,9,28,37,,0,0,0,,0,3,0,2,0,0,14,130,0,
798,Johnny Bansfield,23,306,216,71,42,29,28,28,403,88.38,0,0,0,39.35,13,65,1,6,0,35,174,132,186,
799,Brent Anderson,12,196,0,53,40,13,8,28,185,88.1,0,0,0,,0,25,0,8,0,0,106,90,0,
800,Calvin Brown,14,308,346,61,41,20,15,27,413,87.69,3409,2463,946,52.89,35,47,0,2,0,57,220,88,337,Hybrid
801,Karl Kingma,25,287,243,20,9,11,15,27,50,,8,0,8,34.16,4,6,0,2,0,0,56,231,267,
802,Nick Haser,8,141,104,16,3,13,12,27,27,,0,0,0,57.69,6,1,0,0,0,0,7,134,115,
803,Connor DeLuna,11,170,104,21,1,20,6,27,13,,724,79,645,44.23,0,0,0,0,0,0,15,155,168,
804,Chris Bartoli,10,193,104,19,2,17,11,27,19,,820,106,714,52.88,1,2,0,1,0,0,28,165,185,
805,Jeremy Norden,29,452,426,62,52,10,12,27,458,89.45,0,0,0,42.49,25,46,2,1,0,135,86,366,470,Handler
806,Benjy Keren,29,390,381,48,36,12,5,27,686,96.62,0,0,0,49.61,31,20,0,6,0,1,294,96,301,Handler
807,Lucas Young,30,659,798,52,27,25,9,27,609,93.69,0,0,0,50.5,38,29,0,5,0,2,451,208,608,
808,Wesley Miaw,19,263,242,22,5,17,9,27,175,98.31,1373,806,567,47.52,21,3,3,1,0,0,99,164,285,
809,James Fiala,12,271,341,26,4,22,13,27,135,93.1,0,0,0,25.22,10,9,1,3,0,0,186,85,232,
810,Sam Bumsted,15,290,332,40,19,21,5,27,265,94.31,0,0,0,52.71,26,14,1,4,0,22,174,116,276,Defender
811,William Brandt,9,163,195,36,22,14,2,27,258,95.56,2294,1365,929,56.41,14,11,0,0,0,6,143,20,176,
812,Daniel Naruo,21,268,266,26,17,9,12,27,118,93.65,0,0,0,36.84,7,7,0,4,0,7,111,157,245,
813,Gustav Haflin,9,177,111,20,7,13,9,27,43,,929,265,664,54.95,5,1,0,1,0,0,41,136,166,
814,Timmer Farrell,11,174,152,18,6,12,13,27,44,,0,0,0,45.39,7,4,0,0,0,4,14,160,178,
815,Quentin Roger,12,237,282,46,39,7,1,27,359,93.98,0,0,0,53.19,32,18,0,2,0,2,184,53,256,
816,Jacob Clary,35,355,217,17,1,16,15,27,31,,181,-14,195,37.79,3,4,0,1,0,0,60,295,330,
817,Brian Clark,16,189,135,14,6,8,18,27,43,,0,0,0,47.41,5,3,0,2,0,0,13,176,167,
818,Marc Munoz,34,668,512,63,40,23,16,27,414,89.03,2187,1336,851,38.48,32,47,1,5,0,4,205,463,605,Handler
819,Manuel Eckert,21,484,527,70,51,19,9,27,770,92.88,4952,3402,1550,44.59,50,48,0,4,0,25,323,161,509,Hybrid
820,David Hughes,13,128,0,41,14,27,4,27,93,,0,0,0,,0,12,0,6,0,0,80,48,0,
821,Andrew Sheehan,28,458,488,46,38,8,31,26,515,90.51,0,0,0,36.07,33,46,0,5,0,6,120,338,494,
822,Alex Kapiamba,16,275,247,18,6,12,22,26,52,,0,0,0,26.72,4,12,0,2,0,152,75,200,242,Cutter
823,Nathan White,22,422,389,36,29,7,9,26,277,92.03,0,0,0,46.02,28,19,2,0,1,73,112,310,385,
824,Reid Bacon,23,345,279,27,13,14,14,26,66,,0,0,0,39.43,2,10,0,5,0,0,19,326,286,
825,Joe Brisbois,10,165,0,24,11,13,8,26,34,,0,0,0,,0,3,0,3,0,29,80,85,0,
826,Sam Esser,32,416,282,29,7,22,19,26,152,91.02,0,0,0,25.53,6,15,0,7,0,1,103,313,305,
827,Shane Heath,10,170,218,34,18,16,2,26,115,92.74,2133,836,1297,49.54,8,9,0,1,0,0,165,5,183,
828,Matthew Radhe,45,791,460,57,36,21,18,26,426,90.83,0,0,0,43.91,11,39,0,10,0,17,242,549,489,
829,Noah Chambers,24,334,290,15,4,11,17,26,80,,436,96,340,36.55,10,6,0,0,0,1,37,297,331,
830,Joseph Genest,22,322,324,28,5,23,16,26,54,,0,0,0,33.95,6,12,0,6,0,62,86,236,313,
831,Michael Dayton,23,442,611,43,9,34,6,26,277,95.19,0,0,0,43.7,27,12,0,11,0,0,401,41,425,
832,Brandon Perales,60,958,927,71,60,11,27,26,894,91.6,143,147,-4,45.09,61,64,0,8,1,43,444,514,918,Handler
833,Kyle Cox,96,1577,1467,172,138,34,41,26,2007,90.73,0,0,0,43.69,101,173,0,14,0,50,971,606,1290,Handler
834,Ben Murphy,54,727,704,94,50,44,25,26,709,89.18,0,0,0,29.69,26,83,0,10,0,19,440,287,558,
835,Dan Dantzig,15,156,0,38,27,11,7,26,220,95.24,0,0,0,,0,11,0,8,0,10,80,76,0,
836,Sean Childers,17,208,56,28,10,18,10,25,95,90.48,0,0,0,,5,9,0,4,0,8,10,198,78,
837,Christian Boxley,6,127,154,29,5,24,1,25,61,,0,0,0,52.6,8,4,1,1,0,0,89,38,122,
838,Zach Zebarth,41,424,321,23,8,15,17,25,146,92.41,0,0,0,44.24,15,12,0,3,0,7,98,326,345,
839,Nate Castine,17,313,309,36,23,13,9,25,195,89.45,0,0,0,44.98,24,18,1,2,0,130,94,219,302,
840,Peter Yu,21,473,496,56,45,11,18,25,490,89.58,0,0,0,38.1,25,46,0,3,0,1,244,229,467,
841,Adam Raty,24,369,390,36,18,18,15,25,226,88.98,0,0,0,38.21,20,23,2,3,0,16,120,249,360,
842,Kyle Smith,14,177,120,18,8,10,11,25,30,,0,0,0,45.0,4,3,0,1,0,1,22,155,147,
843,John-Michael Guest,9,49,0,18,1,17,11,25,25,,0,0,0,,0,3,0,1,0,0,26,23,0,
844,Henry Konker,10,189,193,25,12,13,14,25,83,,0,0,0,34.72,13,13,2,1,0,2,66,123,193,
845,Matthew Neeley,31,544,562,45,27,18,34,25,316,85.41,0,0,0,37.01,23,45,0,9,0,99,174,370,536,
846,Seth Reinhardt,24,300,252,27,7,20,5,25,91,,0,0,0,47.22,6,6,0,1,0,0,112,188,247,
847,Cal Tornabene,18,274,173,16,7,9,12,25,74,,539,120,419,47.98,10,3,0,0,0,0,22,252,290,
848,Aaron Roberts,28,333,264,20,10,10,19,25,82,,0,0,0,37.5,6,11,0,3,0,5,60,273,293,
849,Casey Peters,12,78,0,30,12,18,3,25,64,,0,0,0,,0,8,0,0,0,0,30,48,0,
850,Aman Nalavalde,12,87,0,31,6,25,3,25,59,,0,0,0,,0,9,0,0,0,0,48,39,0,
851,Donovan Triplett,36,470,409,34,22,12,19,25,246,89.45,0,0,0,36.19,19,25,0,3,0,9,82,388,473,
852,Kieran Kelly,24,346,381,37,15,22,15,25,282,92.46,0,0,0,35.43,16,22,1,5,0,14,188,158,334,
853,Kevin Tien,16,269,152,19,8,11,15,25,60,,685,185,500,44.74,8,8,0,1,0,70,35,234,243,
854,Khalid Al-Zahrani,20,298,217,16,3,13,16,25,55,,0,0,0,29.03,6,5,0,2,0,0,28,270,271,
855,Neal Phelps,42,662,590,38,22,16,21,25,366,92.89,0,0,0,37.29,29,25,0,9,0,7,156,506,674,Handler
856,Eric Miner,16,275,275,34,7,27,5,25,125,89.29,0,0,0,46.91,10,12,0,2,0,0,122,153,243,
857,Will Huffer,36,552,423,57,24,33,30,25,264,81.23,0,0,0,30.97,14,55,0,7,0,35,242,310,376,
858,Eddie Peters,17,302,283,28,13,15,17,25,145,87.88,0,0,0,36.04,12,17,0,3,0,37,67,235,289,
859,Leo Pierson,16,250,194,16,3,13,16,25,39,,222,44,178,35.57,2,6,0,1,0,1,26,224,258,
860,Matt Bennett,55,1013,932,118,111,7,31,24,1017,87.45,1505,1360,145,43.03,81,123,1,2,0,537,224,789,1034,Handler
861,Dan LaFrance,23,265,191,20,4,16,7,24,30,,468,93,375,41.36,2,1,0,2,0,0,24,241,250,
862,Justin Perticone,15,351,331,34,14,20,19,24,125,83.33,0,0,0,28.1,9,23,0,6,0,1,133,218,383,
863,James Highsmith,13,161,84,21,9,12,12,24,87,,0,0,0,,5,5,0,4,0,1,87,74,70,
864,Eli Artemakis,10,154,158,23,6,17,3,24,84,,1799,286,1513,62.03,12,1,0,1,0,0,126,28,183,
865,Cody Curran,12,183,136,22,8,14,7,24,70,,1172,300,872,48.53,4,4,0,1,0,12,52,131,197,
866,Joseph Marmerstein,16,324,425,48,34,14,9,24,524,93.57,0,0,0,44.47,27,31,2,2,0,2,218,106,334,
867,Michael Panna,12,87,0,29,14,15,12,24,79,,0,0,0,,0,13,0,4,0,0,38,49,0,
868,Eric Sjostrom,12,274,325,37,19,18,4,24,363,94.78,1916,1520,396,47.38,24,15,1,2,0,0,225,49,267,
869,Kyle Weigand,29,396,369,34,10,24,14,24,140,88.05,0,0,0,45.26,17,15,0,9,0,96,97,299,408,Defender
870,Devon Anderson,4,70,90,20,7,13,5,24,38,,0,0,0,,7,1,0,0,0,0,50,20,62,
871,Tim Gilligan,16,371,360,42,18,24,8,24,204,89.08,0,0,0,48.06,18,25,0,1,0,132,113,258,348,
872,Ted Barnett,32,579,464,45,25,20,19,24,307,88.22,0,0,0,43.53,37,34,2,6,0,386,58,521,515,
873,Garrett Martin,10,196,112,23,20,3,11,24,118,92.19,1661,1244,417,43.75,8,8,1,2,0,42,6,190,208,Hybrid
874,Luke Marks,12,206,144,16,4,12,10,24,60,,773,289,484,53.47,10,2,0,0,0,13,11,195,210,
875,Robbie Farwell,14,240,197,27,10,17,5,24,56,,0,0,0,46.7,8,7,0,1,0,0,60,180,239,
876,Davis Whitehead,10,162,166,16,4,12,12,24,81,,91,47,44,50.6,11,4,0,0,0,0,30,132,166,
877,Christian Pitts,8,219,214,26,7,19,5,24,64,,0,0,0,53.27,10,3,0,4,0,1,113,106,180,
878,Nick Slovan,21,329,396,37,14,23,8,24,217,92.74,0,0,0,43.94,26,16,1,5,0,1,213,116,305,
879,Taylor Nadon,13,262,329,37,16,21,2,24,119,91.54,0,0,0,48.33,9,9,0,6,0,2,203,59,213,
880,Johnny Sisto,12,242,299,30,6,24,5,24,40,,0,0,0,36.12,9,8,0,3,0,0,175,67,236,
881,Kiron Allen,36,563,677,48,17,31,3,24,661,96.08,41,84,-43,58.94,42,23,1,4,0,0,471,92,531,Handler
882,Jeremy Hess,13,245,167,17,11,6,10,23,55,,819,402,417,50.3,4,4,0,0,0,139,39,206,269,
883,Michael Petersen,27,488,259,49,35,14,27,23,280,85.89,0,0,0,40.54,12,41,0,12,0,172,188,300,262,
884,Stephen Rosso,26,437,397,30,14,16,16,23,182,91.46,0,0,0,30.98,8,17,0,6,0,12,86,351,440,
885,Julian Hausman,13,259,278,41,23,18,5,23,96,79.34,0,0,0,43.17,9,19,0,4,0,51,130,129,265,
886,Dylan Best,11,231,282,39,17,22,0,23,264,93.29,0,0,0,54.96,29,14,0,2,0,0,191,40,248,
887,Sam Morgan,37,360,189,27,10,17,18,23,163,87.17,0,0,0,31.75,2,21,0,1,0,33,132,228,209,
888,Benet Clark,26,381,322,28,10,18,16,23,132,89.19,0,0,0,45.03,10,13,0,8,0,0,150,231,301,
889,Dan Hassell,21,173,0,27,13,14,8,23,108,99.08,0,0,0,,0,10,0,2,0,0,51,122,0,
890,Seth Canetti,30,336,120,63,46,17,15,23,681,93.42,0,0,0,41.67,12,43,3,12,0,0,251,85,95,
891,Hugh Knapp,7,136,184,31,18,13,2,23,158,94.05,0,0,0,52.17,14,9,0,1,0,5,107,29,134,
892,Nicholas Hunter,22,248,171,24,5,19,5,23,70,,0,0,0,36.26,8,5,0,1,1,0,34,214,203,
893,Nick Thompson,8,165,183,26,4,22,2,23,89,,1769,491,1278,60.66,12,4,0,1,0,0,151,14,168,
894,Justin Schroeder,20,369,442,47,26,21,7,23,184,88.46,0,0,0,42.31,15,21,1,10,0,0,271,98,353,
895,Ryan Swift,22,376,346,26,13,13,14,23,220,93.62,0,0,0,43.64,19,11,0,6,0,0,116,260,347,
896,Dylan Welchman,21,331,287,22,9,13,12,23,117,93.6,0,0,0,38.33,14,6,0,5,0,0,121,210,314,
897,Ben Snell,12,281,248,33,14,19,11,23,191,91.39,1101,736,365,48.39,22,15,0,6,0,46,90,191,261,Cutter
898,John Stubbs,7,145,137,29,22,7,3,23,114,92.68,2065,1381,684,55.47,16,8,0,1,0,0,95,50,159,
899,Andrew Roy,13,265,320,38,25,13,5,23,674,97.12,3957,3843,114,57.19,33,18,3,2,0,2,224,41,286,
900,Grayson Pangburn,31,457,363,29,9,20,10,23,129,91.49,217,95,122,44.9,12,12,0,4,0,7,88,369,403,Defender
901,Logan Weiss,13,210,178,23,10,13,9,23,102,94.44,0,0,0,47.19,8,6,1,3,0,11,34,176,177,
902,Sean Newlin,16,232,293,32,16,16,14,22,126,83.44,0,0,0,37.88,14,20,0,4,0,0,132,100,241,
903,Skylohr Taylor,17,226,155,19,2,17,6,22,46,,152,26,126,34.84,2,3,0,0,0,0,47,179,188,
904,Brian Baker,18,265,232,25,5,20,12,22,59,,0,0,0,33.19,4,10,0,5,0,3,42,223,236,
905,Sean Plunkett,11,247,214,22,5,17,9,22,99,91.67,1728,552,1176,35.98,12,8,0,1,0,2,116,131,263,
906,Dongyang Chen,11,171,148,18,5,13,6,22,29,,0,0,0,39.19,2,1,0,1,0,0,26,145,163,
907,Sean Keegan,19,407,532,78,58,20,4,22,639,90.77,0,0,0,46.05,30,60,1,0,0,10,374,33,399,
908,Alec Benton,19,365,279,32,18,14,15,22,108,80.0,0,0,0,39.43,12,22,0,3,0,232,58,307,338,
909,Jonathan Palumbo,22,222,48,24,9,15,16,22,81,,0,0,0,,4,11,0,7,0,0,21,201,56,
910,Alex Champe,21,378,417,57,37,20,20,22,307,83.65,0,0,0,30.7,15,47,0,8,0,22,144,234,386,
911,George Hughes-Strange,10,188,99,23,15,8,18,22,167,91.26,0,0,0,,4,16,0,3,0,10,50,138,86,
912,Tim DeByl,25,329,90,24,13,11,12,22,147,93.04,0,0,0,,1,9,1,5,0,4,65,264,108,
913,Carter Middleton,13,293,330,27,14,13,16,22,129,85.43,0,0,0,30.91,13,18,0,3,0,1,163,130,269,
914,Ben Breault,26,490,414,47,34,13,15,22,241,86.07,0,0,0,35.75,15,31,0,9,0,39,132,358,407,
915,Mike Moses,14,184,151,16,6,10,11,22,42,,0,0,0,35.76,6,4,0,1,0,0,22,162,158,
916,Ari Nitikman,24,456,461,33,16,17,8,22,304,92.97,0,0,0,43.38,19,14,0,5,0,0,235,221,419,
917,Matthew Hogel,24,406,483,44,19,25,11,22,440,92.05,0,0,0,42.24,25,28,1,5,0,0,241,165,381,
918,Jeremy Keusch,18,278,210,19,8,11,13,22,126,92.65,1379,580,799,43.33,10,9,0,1,0,1,73,205,273,
919,Andrew Lynch,21,403,450,36,22,14,13,22,483,93.24,0,0,0,42.67,36,25,0,2,0,41,240,163,378,
920,Kyle Khalifa,13,154,209,27,9,18,6,22,67,,0,0,0,44.5,8,7,0,4,0,1,97,57,195,
921,Grant Boyd,18,290,345,33,17,16,5,22,286,94.39,0,0,0,45.51,19,16,0,0,0,8,207,83,307,
922,Stephen Ierardi,26,360,262,27,13,14,13,22,126,88.11,0,0,0,35.88,12,13,0,5,0,22,37,323,303,
923,Matt Muhlenkamp,10,148,181,31,11,20,4,22,68,,0,0,0,37.02,11,10,0,3,0,0,100,48,156,
924,Jordan Dhillon,13,182,188,29,6,23,6,22,51,,0,0,0,49.47,8,9,0,4,0,0,113,69,153,
925,Eric EJ Johnson,17,372,418,49,37,12,10,22,356,89.67,0,0,0,41.63,27,32,2,5,0,51,218,154,373,Hybrid
926,Phil Cherosky,20,262,161,50,41,9,17,21,276,85.98,0,0,0,34.16,3,39,0,7,0,2,112,150,166,
927,Jack Hefferon,22,270,205,11,0,11,15,21,23,,0,0,0,35.61,2,4,0,1,0,2,39,231,270,
928,Kory Helms,14,254,235,21,5,16,3,21,105,98.13,0,0,0,46.38,12,2,0,1,0,0,132,122,237,
929,Nash Mock,18,255,210,19,6,13,8,21,42,,-1,-3,2,44.76,9,5,0,1,0,2,93,162,197,
930,Dylan Power,20,289,349,31,11,20,4,21,407,96.22,2543,1657,886,52.44,20,13,1,1,0,1,233,56,330,
931,Gus Norrbom,11,163,192,25,16,9,1,21,355,98.61,2327,1556,771,64.58,17,3,1,2,0,0,157,6,205,
932,Patrick Lahey,9,124,130,22,2,20,8,21,42,,0,0,0,40.77,5,6,0,3,0,0,56,68,122,
933,Brendan Awerbuch,43,571,362,67,46,21,17,21,790,93.05,0,0,0,50.0,24,58,0,5,0,1,403,168,279,
934,Michael Volz,5,125,155,26,7,19,0,21,60,,0,0,0,54.19,11,3,0,2,0,0,114,11,113,
935,CJ Clarke,19,263,230,18,3,15,11,21,64,,0,0,0,49.13,6,4,0,4,0,0,115,148,236,
936,Zach Slayton,12,225,194,24,7,17,10,21,159,95.21,1758,892,866,53.09,12,7,1,6,0,2,85,140,225,
937,Anthony Cain,12,78,0,23,8,15,10,21,89,89.0,0,0,0,,0,11,0,1,0,0,43,35,0,
938,Alexander Morris,18,238,179,21,7,14,7,21,79,,0,0,0,42.46,10,4,0,3,0,6,69,169,205,
939,Gabriel Hernandez,28,473,390,42,26,16,10,21,525,94.09,2318,1608,710,48.72,28,28,1,3,0,70,164,309,478,
940,Adam Vinson,20,319,367,33,4,29,5,21,151,92.07,1287,133,1154,43.32,13,12,1,5,0,2,240,79,338,
941,Mike Ogren,9,225,258,33,19,14,6,21,155,88.07,0,0,0,43.41,11,17,2,1,0,0,125,100,220,
942,Alton Gaines,14,259,242,29,12,17,12,21,94,85.45,0,0,0,45.87,4,16,0,4,0,0,114,145,240,
943,Tom Rosatto,7,153,149,25,11,14,1,21,92,,0,0,0,63.09,5,3,1,2,0,0,94,59,125,
944,Ryo Senda,12,186,210,26,11,15,5,21,78,,0,0,0,60.0,10,10,0,0,0,1,145,41,174,
945,Nicholas DiGiorgio,18,268,228,29,11,18,5,21,93,86.11,965,324,641,39.04,5,10,0,3,0,0,93,175,281,Defender
946,David Wenzel,18,203,62,19,8,11,16,21,90,,0,0,0,,5,4,1,10,0,0,60,143,45,
947,Bryce Ring,49,743,713,42,28,14,15,20,601,93.61,82,68,14,42.92,33,34,0,3,0,0,315,428,631,
948,Liam Searles Bohs,7,119,91,16,10,6,8,20,87,,0,0,0,,6,4,0,0,0,48,14,105,113,
949,Sam Batson,17,206,139,22,4,18,5,20,53,,29,8,21,49.64,2,7,0,0,0,7,64,142,184,
950,Mike Becich,6,122,86,20,2,18,4,20,18,,0,0,0,,4,3,0,1,0,0,46,76,94,
951,Jonathan Lee,12,228,0,32,20,12,17,20,223,90.28,0,0,0,,0,24,0,5,0,2,106,122,0,
952,Zac Sands,11,165,200,25,3,22,6,20,74,,0,0,0,44.5,8,8,0,3,0,0,114,51,186,Cutter
953,Kevin Hoercher,9,144,0,18,6,12,8,20,52,,0,0,0,,0,4,0,2,0,0,29,115,0,
954,Zach Maynard,14,116,16,12,3,9,12,20,19,,0,0,0,,1,2,0,2,0,1,20,96,21,
955,Ben Pries,18,265,193,11,3,8,12,20,32,,0,0,0,40.41,4,2,0,1,0,0,26,239,258,
956,Ryan Hiser,23,319,356,38,20,18,5,20,215,90.72,610,355,255,43.54,17,21,0,2,0,5,221,98,359,
957,Joe Anderson,10,96,0,26,10,16,14,20,138,87.9,0,0,0,,0,19,0,1,0,0,48,48,0,
958,Joe Freund,6,103,117,28,8,20,2,20,59,,0,0,0,56.41,6,6,0,4,0,0,71,32,99,
959,Joshua Venegas,11,161,98,8,1,7,14,20,12,,273,77,196,,1,1,0,1,1,0,1,160,168,
960,Tim Schoch,9,164,97,18,10,8,4,20,149,98.03,1149,954,195,,9,1,0,1,1,0,12,152,202,
961,Cole Jensen,22,221,189,14,8,6,16,20,88,86.27,0,0,0,33.33,5,9,0,1,0,18,46,175,194,
962,Collin Gall,20,360,384,36,27,9,6,20,345,93.24,1835,1850,-15,46.61,18,22,0,0,0,19,226,134,378,Handler
963,Nick Lance,9,236,192,24,14,10,12,20,191,91.83,0,0,0,42.19,20,14,0,2,0,86,74,162,235,
964,Josh Kohl,26,353,294,31,16,15,7,20,205,91.11,0,0,0,43.88,9,18,0,0,0,0,84,269,314,
965,Jeffrey Woo,8,95,107,18,2,16,4,20,24,,0,0,0,52.34,0,1,1,1,0,0,61,34,72,
966,Josh Nickerson,27,466,367,27,7,20,14,20,83,82.18,0,0,0,34.6,9,17,0,4,0,2,138,328,395,
967,David Janssen,20,367,500,32,13,19,8,20,495,95.93,0,0,0,48.0,28,18,1,2,0,0,330,37,365,
968,Mario O'Brien,22,554,701,51,31,20,9,20,633,93.36,0,0,0,51.64,46,34,3,6,0,0,476,78,493,
969,Kevin Norton,13,228,322,30,9,21,9,20,121,88.97,0,0,0,41.3,21,14,0,5,0,0,194,34,232,
970,Ross Lenta,16,235,303,32,13,19,3,20,168,94.38,0,0,0,45.87,22,10,0,5,0,0,202,33,222,
971,Blake Hannah,9,180,198,30,15,15,8,20,120,86.33,0,0,0,41.41,12,15,1,3,0,29,81,99,177,
972,Jeff Maskalunas,12,168,161,16,8,8,12,20,52,,0,0,0,37.27,3,4,0,4,1,0,38,130,193,Defender
973,Eric Witmer,16,265,164,19,9,10,12,20,85,,1592,747,845,41.46,10,6,0,5,0,0,40,225,301,Defender
974,Austin Johnson,22,366,372,16,5,11,22,20,233,92.46,172,111,61,30.91,9,15,0,3,0,11,178,188,387,
975,John Bergen,22,324,100,21,10,11,13,20,157,92.9,0,0,0,54.0,5,12,0,2,0,19,56,268,116,
976,Eamon Pinto,15,216,159,20,4,16,8,20,48,,0,0,0,40.88,3,3,0,5,0,0,64,152,144,
977,Alex Nord,11,176,243,31,18,13,8,19,115,86.47,0,0,0,42.8,14,14,2,6,0,4,123,53,187,
978,Andrew Wilkes,11,164,216,19,5,14,5,19,93,,0,0,0,43.52,11,4,0,1,0,0,128,36,165,
979,Orion Cable,6,145,159,22,8,14,6,19,68,,2011,696,1315,59.75,17,6,0,3,0,0,126,19,143,
980,Troy Revell,26,301,0,66,39,27,11,19,650,92.46,0,0,0,,0,53,0,5,0,4,226,75,0,
981,Bill Kluender,19,234,188,18,7,11,12,19,79,,0,0,0,35.64,5,9,0,2,0,143,45,189,232,
982,Tristan Green,38,641,470,61,52,9,10,19,460,89.49,40,26,14,43.19,37,50,0,2,0,130,61,580,587,Handler
983,Devon Rogers,13,199,183,18,5,13,5,19,58,,261,65,196,54.1,6,2,0,2,1,0,114,85,172,
984,Willem Maessen,12,106,0,24,14,10,5,19,44,,0,0,0,,0,5,0,5,0,4,33,73,0,
985,Frank Strasser,20,303,232,15,5,10,14,19,42,,0,0,0,25.86,4,7,0,3,0,0,53,250,275,
986,Phillip Kaye,12,117,0,28,8,20,3,19,61,,0,0,0,,0,6,0,6,0,16,46,71,0,
987,Jaret Meron,77,1247,1098,80,49,31,37,19,777,88.1,313,345,-32,43.62,57,90,0,8,0,739,189,1058,1223,
988,Nick Hirannet,15,145,0,50,33,17,6,19,257,90.18,0,0,0,,0,28,0,9,0,0,91,54,0,
989,Jesse Bolton,25,421,384,33,25,8,22,19,226,86.59,0,0,0,39.06,12,30,1,6,0,110,144,277,394,
990,Robert Alongi,14,175,152,14,9,5,12,19,56,,176,93,83,30.92,8,5,0,2,0,0,46,129,206,
991,Brandon Malecek,82,1631,1906,254,202,52,34,19,2986,91.91,1276,1246,30,52.57,179,243,1,26,0,77,1326,305,1487,Handler
992,Sam Sohn,32,577,746,56,31,25,9,19,650,93.66,0,0,0,50.13,40,36,0,10,0,3,427,150,579,
993,Richard Tam,27,540,476,26,9,17,12,19,242,92.72,0,0,0,42.86,16,18,0,1,0,3,154,386,443,
994,Nathan Haskell,7,147,112,17,10,7,8,19,47,,0,0,0,46.43,3,6,0,0,0,6,55,92,125,
995,Kevin Kula,33,250,74,25,4,21,9,19,52,,0,0,0,,1,10,0,5,0,0,50,200,101,
996,Brett Sullivan,23,389,430,18,6,12,21,19,283,94.65,0,0,0,33.72,14,13,0,7,0,0,138,251,394,
997,Philippe Bisson,21,313,239,14,3,11,8,19,55,,0,0,0,33.47,3,3,0,0,0,0,48,265,305,
998,Andrew Kohl,23,360,253,13,3,10,12,19,90,,0,0,0,41.11,8,4,0,2,0,0,30,330,312,
999,Lance Young,9,126,95,15,6,9,9,19,33,,0,0,0,,4,3,0,2,0,5,9,117,109,
1000,Max Cook,13,265,353,39,23,16,3,19,452,95.16,0,0,0,47.59,31,20,0,3,0,0,237,28,276,
1001,Colin Froats,42,485,406,22,10,12,11,19,191,91.83,0,0,0,37.93,15,9,0,5,0,4,107,378,397,
1002,Nicholas Hirning,12,146,86,11,8,3,12,19,50,,0,0,0,,3,4,0,0,0,1,13,133,131,
1003,Matt Weintraub,42,518,274,42,33,9,10,19,486,94.19,358,510,-152,48.54,20,28,1,5,0,2,93,425,440,Handler
1004,Adam O'Donnell,28,410,464,34,13,21,4,19,228,93.44,57,28,29,46.34,29,11,0,8,0,0,310,100,388,
1005,Devon Williams,19,293,185,12,5,7,14,19,50,,0,0,0,40.0,5,3,0,4,0,0,29,264,235,
1006,Kevin Aha,5,84,105,20,5,15,1,19,26,,0,0,0,61.9,8,2,0,0,0,0,59,25,62,
1007,Michael Natenberg,7,152,182,26,19,7,2,18,175,94.09,0,0,0,50.55,13,9,2,1,0,0,131,21,145,
1008,Joe Thompson,26,417,354,59,30,29,8,18,426,89.68,48,19,29,39.83,18,46,0,3,0,4,296,121,298,
1009,Jason Cheek,16,217,204,17,10,7,6,18,80,,0,0,0,35.29,7,5,0,0,0,24,52,165,214,
1010,Joe Mozloom,21,422,412,25,15,10,13,18,194,91.51,0,0,0,26.46,18,17,0,3,0,4,135,287,414,
1011,Ethan Peck,29,661,853,121,86,35,19,18,686,84.38,0,0,0,37.16,49,107,0,15,0,38,441,220,713,Handler
1012,Nick Gigliotti,17,258,204,17,7,10,7,18,61,,0,0,0,39.22,4,3,0,3,0,1,68,190,229,
1013,Jordan Queckboerner,11,141,97,11,1,10,13,18,30,,779,63,716,,4,5,0,1,0,0,10,131,165,Defender
1014,Blake Vanderbush,26,322,121,22,14,8,9,18,384,96.73,0,0,0,49.59,4,12,0,1,0,1,197,125,117,
1015,Kamron Daftari,14,178,129,12,0,12,8,18,21,,22,-6,28,45.74,2,2,0,0,0,0,27,151,148,Cutter
1016,Bryan Walsh,17,380,468,57,48,9,5,18,613,93.02,5979,4064,1915,38.68,27,40,1,4,0,1,338,42,402,
1017,Anthony McLean,18,272,319,29,8,21,6,18,110,86.61,0,0,0,39.5,7,13,0,4,0,1,145,127,280,
1018,Russell Howd,28,412,352,26,12,14,15,18,155,88.07,0,0,0,39.77,19,18,1,5,0,0,74,338,389,
1019,Jared Seyler,14,184,200,24,6,18,6,18,40,,0,0,0,35.0,5,9,0,3,0,0,93,91,170,
1020,Scott Hampton,8,68,0,16,1,15,7,18,41,,0,0,0,,0,4,0,1,0,1,19,49,0,
1021,Martin Le,7,81,79,17,5,12,4,18,70,,886,244,642,,5,1,0,2,0,0,37,44,95,
1022,Jason Duiella,9,163,129,10,1,9,13,18,27,,0,0,0,35.66,1,2,0,3,0,1,32,131,141,
1023,Alex Edinger,15,164,0,46,31,15,10,18,194,87.0,0,0,0,,0,29,0,9,0,0,80,84,0,
1024,Justin Badgett,11,155,128,13,4,9,8,18,36,,0,0,0,33.59,6,0,0,3,0,0,45,110,142,
1025,Peter Galbraith,8,130,148,17,5,12,6,18,33,,0,0,0,39.19,2,3,0,2,0,1,72,58,121,
1026,Drew Chandler,13,203,201,23,7,16,4,18,104,95.41,0,0,0,49.75,15,5,0,4,0,0,89,114,182,
1027,Renaldo Artega,12,206,176,12,4,8,9,18,61,,0,0,0,43.18,8,2,0,1,0,2,18,188,168,
1028,Dennis Casio,30,621,573,46,40,6,7,18,674,94.13,1700,1752,-52,42.76,40,33,0,2,0,3,319,302,620,Handler
1029,Kohji Sugioka,20,267,225,17,9,8,14,18,64,,0,0,0,36.89,8,6,1,7,0,0,47,220,248,
1030,Paul Owens,18,291,230,25,13,12,8,18,160,90.91,1824,1123,701,41.74,13,13,0,2,0,21,101,190,323,Cutter
1031,Ignacio Yz,10,158,233,30,12,18,1,18,98,89.09,0,0,0,39.06,5,12,0,1,0,5,146,12,173,
1032,Joel Wooten,7,113,98,16,2,14,7,18,27,,0,0,0,,3,4,0,1,0,0,47,66,120,
1033,Luke Jespersen,12,217,239,14,3,11,10,18,46,,0,0,0,28.03,7,4,0,2,0,0,28,189,230,
1034,Marc Pisansky,8,117,118,22,10,12,7,18,75,,0,0,0,47.46,4,8,0,3,0,12,55,62,99,
1035,Matt Theologidy,42,607,491,33,27,6,15,18,434,92.93,265,185,80,43.18,33,26,1,4,0,205,121,486,582,Handler
1036,Noah Robinson,3,66,79,18,3,15,2,18,37,,0,0,0,,7,2,0,0,0,0,52,14,64,
1037,Sam Ward,16,278,288,30,9,21,7,17,102,85.0,0,0,0,41.32,9,18,0,2,0,70,88,190,271,
1038,Tyler Grant,13,254,205,24,15,9,9,17,88,84.62,0,0,0,41.95,12,15,0,1,0,137,53,201,201,
1039,James Roush,17,224,67,18,6,12,4,17,89,,0,0,0,,2,3,0,2,0,1,87,137,86,
1040,Dana Grandoni,12,78,0,24,9,15,6,17,84,,0,0,0,,0,9,0,4,0,0,36,42,0,
1041,Nick Peppers,21,216,114,29,5,24,7,17,142,95.3,0,0,0,31.58,1,17,1,2,0,0,72,144,144,
1042,Matt Weiner,18,166,207,15,2,13,8,17,61,,0,0,0,41.55,8,4,0,2,0,0,129,37,170,
1043,TJ Stanton,19,207,102,13,3,10,8,17,26,,49,-11,60,46.08,3,2,0,2,0,27,1,206,172,
1044,Matt Tacheron,14,238,0,32,12,20,14,17,117,84.78,0,0,0,,0,21,0,8,0,53,120,118,0,
1045,Ryan Keyfitz,13,147,0,33,22,11,6,17,170,89.47,0,0,0,,0,20,0,2,0,1,49,98,0,
1046,Tanner Robinson,11,172,165,19,11,8,7,17,139,94.56,1733,1083,650,56.36,7,8,1,1,0,0,107,65,202,
1047,Dan Miller,12,200,201,25,12,13,3,17,143,92.86,0,0,0,51.24,13,6,0,5,0,17,99,101,175,
1048,Ryan Lee,24,528,593,55,44,11,13,17,636,90.73,0,0,0,44.18,59,48,2,3,0,35,313,215,455,
1049,Jacob Miller,10,158,108,14,2,12,8,17,36,,856,149,707,53.7,5,2,0,3,0,0,15,143,179,
1050,Marc Sands,13,255,269,29,10,19,8,17,160,90.4,1107,486,621,46.47,24,15,0,5,0,16,156,99,258,Cutter
1051,Spencer Wallis,12,251,264,37,24,13,2,17,93,80.17,0,0,0,46.59,6,20,0,2,0,7,158,93,212,
1052,Peter Barry,11,200,235,22,6,16,7,17,125,91.91,0,0,0,42.98,18,9,0,3,0,0,145,55,195,
1053,Ryan Sturm,12,209,211,21,9,12,13,17,46,,41,-11,52,30.33,4,10,0,7,0,0,30,179,219,Cutter
1054,John Groess,18,271,56,17,11,6,13,17,194,92.38,0,0,0,,1,11,0,2,0,2,69,202,46,
1055,Adam Johnston,13,111,0,37,16,21,4,17,131,87.92,0,0,0,,0,18,0,6,0,0,56,55,0,
1056,James Franklin,10,194,194,18,1,17,5,17,60,,0,0,0,42.78,7,2,0,4,0,0,102,92,194,
1057,Dominic Jacobs,11,159,98,12,1,11,8,17,20,,618,172,446,,4,1,0,2,0,4,15,144,162,Cutter
1058,Austin Koffarnus,16,193,141,10,0,10,14,17,27,,0,0,0,35.46,2,4,0,3,0,0,45,148,194,
1059,Parker Howard,13,326,424,42,22,20,5,17,214,89.54,0,0,0,36.08,16,21,0,9,0,0,268,58,311,Cutter
1060,Caleb Stanish,11,211,156,13,5,8,9,17,50,,883,105,778,26.92,7,3,0,2,0,0,78,133,212,
1061,Paul Starkel,40,731,910,81,67,14,11,17,972,92.05,3129,2658,471,46.37,71,69,0,6,0,0,551,180,745,Handler
1062,Stephen Bender,21,345,268,28,19,9,9,17,113,89.68,0,0,0,40.3,7,13,0,7,0,97,24,321,308,
1063,Tannon Hedges,13,212,216,31,13,18,2,17,160,91.43,2297,925,1372,43.98,8,11,0,5,0,1,131,81,222,
1064,Samuel Reis,11,152,179,17,11,6,15,17,55,,0,0,0,36.31,5,8,0,7,0,41,42,110,145,
1065,Dustin Damiano,38,633,801,74,43,31,8,17,1051,93.84,3874,3517,357,46.19,66,61,0,4,0,3,520,113,700,Hybrid
1066,Stephen Ng,47,840,886,60,39,21,28,17,738,90.44,0,0,0,30.59,27,63,0,8,0,34,351,489,837,
1067,Nick Dare,13,238,369,28,22,6,6,17,469,95.52,0,0,0,37.13,23,17,0,0,0,2,219,19,261,
1068,Houston Parks,26,372,255,17,9,8,11,17,63,,401,162,239,34.51,6,6,0,5,0,0,36,336,357,
1069,Trevor Smith,12,157,109,12,2,10,9,17,16,,0,0,0,40.37,3,3,0,1,0,0,9,148,128,
1070,Nick Murphy,10,141,195,21,6,15,1,17,62,,0,0,0,45.64,7,4,0,1,0,0,121,20,135,
1071,Samson Hoy,18,248,273,23,14,9,10,17,167,89.3,0,0,0,36.26,15,14,0,2,0,5,92,156,236,
1072,Eric Dion,14,268,359,39,33,6,1,17,454,93.61,0,0,0,39.28,25,22,0,1,0,0,238,30,267,
1073,Mike Moore,13,218,139,16,6,10,7,17,38,,0,0,0,45.32,3,5,0,1,0,1,13,205,158,
1074,Connor McFayden,8,159,146,17,8,9,5,17,60,,0,0,0,42.47,7,3,0,2,0,3,78,81,133,
1075,Spencer Brown,11,219,206,24,6,18,9,17,54,,0,0,0,26.21,4,8,0,8,0,2,57,162,168,
1076,Will Murphy,5,15,0,6,1,5,15,17,21,,0,0,0,,0,3,0,1,0,0,6,9,0,
1077,Bret Bergmeier,12,191,141,18,5,13,5,16,128,94.12,1430,461,969,50.35,10,6,0,1,0,1,35,156,223,
1078,Ryan Poloz,7,129,171,22,12,10,0,16,143,94.08,1705,1144,561,52.63,15,6,0,0,0,0,126,3,148,
1079,Harrison Treegoob,12,70,0,21,10,11,11,16,72,,0,0,0,,0,12,0,4,0,0,29,41,0,
1080,Craig Poeppelman,7,112,0,12,8,4,10,16,72,,0,0,0,,0,5,1,1,0,1,8,104,0,
1081,Ted Chu,16,277,270,24,9,15,9,16,75,,0,0,0,33.7,10,9,0,8,0,1,100,177,218,
1082,David Berg,12,246,323,42,27,15,5,16,221,87.35,0,0,0,43.03,12,30,1,1,0,2,199,47,255,
1083,Eric Olson,30,521,362,51,38,13,16,16,752,93.77,0,0,0,40.88,25,46,1,5,0,1,365,156,313,
1084,Dang Khoa Dang,10,49,0,19,3,16,3,16,33,,0,0,0,,0,4,0,2,0,0,22,27,0,
1085,Scott Hearne,12,166,105,18,16,2,5,16,106,93.81,899,908,-9,47.62,3,7,0,0,0,93,19,147,167,
1086,Kodi Smart,20,513,632,85,56,29,4,16,717,91.22,0,0,0,46.52,60,63,0,10,0,0,425,88,491,
1087,Matthew Mcknight,12,201,239,30,17,13,1,16,219,94.4,3181,1770,1411,63.6,19,12,0,3,0,0,201,0,197,Handler
1088,Rob Allan,13,161,4,13,1,12,7,16,48,,0,0,0,,0,2,0,2,0,0,54,107,5,
1089,Mitchell McCarthy,11,171,183,14,2,12,9,16,60,,0,0,0,43.72,9,6,0,1,0,1,92,79,176,Defender
1090,Jake Thorne,8,135,104,15,6,9,7,16,81,,1276,585,691,48.08,5,4,0,2,0,0,20,115,156,
1091,Casey Startzell,26,532,658,41,13,28,9,16,751,95.55,0,0,0,39.06,36,31,0,3,0,1,396,136,518,
1092,Matthew Heath,10,46,0,15,3,12,6,16,28,,0,0,0,,0,4,0,1,0,0,19,27,0,
1093,Seamus Robinson,8,150,102,13,6,7,10,16,57,,847,183,664,38.24,3,6,0,1,0,1,3,147,187,Defender
1094,Richard Stacklin,9,198,292,43,25,18,3,16,149,84.18,0,0,0,36.99,9,22,0,8,0,0,174,24,225,
1095,Cody Rebholz,10,45,0,15,10,5,5,16,27,,0,0,0,,0,3,0,1,0,0,24,21,0,
1096,John Norris,11,244,299,40,34,6,0,16,369,92.95,0,0,0,53.18,33,23,1,1,0,1,225,19,194,
1097,Trey Dynes,12,230,227,26,7,19,4,16,128,92.75,2081,425,1656,52.42,11,10,1,4,0,0,131,99,252,
1098,Terry Roth,9,37,0,12,2,10,6,16,17,,0,0,0,,0,2,0,0,0,0,15,22,0,
1099,Connor Fotin,11,288,395,40,19,21,1,16,212,90.21,0,0,0,35.19,17,20,0,5,0,1,259,29,287,
1100,Jimmy Robin,26,261,174,19,16,3,14,16,134,91.16,0,0,0,33.91,8,13,0,4,0,4,22,239,188,
1101,Aaron Corley,26,256,82,18,5,13,15,16,88,85.44,0,0,0,,0,15,0,2,0,0,43,213,91,
1102,Luke Phelan,20,244,204,16,8,8,7,16,62,,0,0,0,43.63,5,7,0,0,0,28,35,209,183,
1103,Tyler French,10,135,94,15,3,12,5,16,22,,30,8,22,,2,3,0,1,0,5,44,91,133,
1104,Elliott Erickson,8,138,122,12,4,8,11,16,50,,0,0,0,40.16,5,7,0,0,0,1,55,83,135,
1105,Will Neff,5,126,128,17,10,7,9,16,70,,0,0,0,43.75,9,6,0,4,0,59,51,75,116,
1106,David Trett,9,177,164,18,6,12,1,16,63,,0,0,0,41.46,8,2,0,1,0,0,85,92,144,
1107,Nicholas Alexander,14,227,248,27,19,8,5,16,261,94.22,0,0,0,39.92,9,14,0,2,0,0,109,118,230,
1108,Marquis Mason,16,160,152,12,1,11,6,16,11,,0,0,0,38.16,3,0,0,2,0,0,42,118,158,
1109,Jon Hallett,15,204,129,10,4,6,12,16,27,,103,2,101,28.68,2,3,0,3,0,0,18,186,210,
1110,Aaron Richards,10,192,201,23,10,13,7,16,87,85.29,0,0,0,35.32,8,11,0,3,0,29,71,121,196,
1111,Andy Smith,18,316,287,21,12,9,8,16,243,94.55,0,0,0,36.24,15,11,0,2,0,2,98,218,309,
1112,Peter Bender,13,258,379,47,21,26,4,16,229,88.42,0,0,0,37.47,15,28,0,7,0,2,226,32,269,
1113,Patrick Dougherty,12,250,283,45,30,15,8,16,221,86.33,0,0,0,39.58,11,31,0,6,0,2,177,73,210,
1114,Oak Nelson,7,136,143,14,5,9,6,16,87,,0,0,0,39.86,5,4,0,0,0,0,79,57,137,
1115,Ryan Sitler,24,447,180,51,33,18,14,16,389,88.81,0,0,0,36.67,14,41,1,8,0,278,127,320,229,
1116,Alex Kadesch,7,141,187,22,7,15,4,16,82,,0,0,0,33.69,6,9,0,1,0,2,121,20,128,
1117,Francisco Mogollon,13,237,240,29,17,12,10,16,80,,0,0,0,37.5,14,18,1,5,0,7,49,188,213,
1118,Aaron Buss,16,244,233,21,15,6,12,16,164,89.13,0,0,0,51.07,16,17,0,0,0,2,77,167,207,
1119,Benjamin Spielman,12,158,106,8,3,5,9,16,53,,0,0,0,42.45,6,0,0,1,0,0,24,134,136,
1120,Peter Van Brussel,13,222,159,21,15,6,8,16,188,93.07,0,0,0,42.14,9,12,0,1,0,112,38,184,217,
1121,Rob Schmidt,9,138,118,15,5,10,9,16,24,,0,0,0,35.59,2,6,0,2,0,18,16,122,114,
1122,Francis Breton,25,303,282,25,5,20,4,16,95,94.06,0,0,0,37.59,7,4,0,9,0,0,91,212,268,
1123,Logan Kinney,12,195,163,16,6,10,8,15,54,,0,0,0,42.94,6,8,0,1,0,0,44,151,148,
1124,Henry Schneider,16,193,155,13,7,6,9,15,68,,0,0,0,38.06,2,7,0,0,0,46,57,136,184,
1125,Jordan Wiley,14,312,425,39,18,21,2,15,211,90.56,0,0,0,35.76,13,21,0,5,0,0,262,50,340,
1126,Adam Bronstein,17,317,427,24,15,9,12,15,367,93.38,0,0,0,41.22,26,21,0,0,0,0,228,89,327,
1127,Jordan Bates,16,252,174,13,1,12,7,15,53,,0,0,0,28.74,5,1,0,4,0,0,44,208,185,
1128,Myles Cooper,11,147,82,6,0,6,10,15,19,,251,22,229,,0,0,0,1,0,0,2,145,153,
1129,Robert Gormley,9,117,128,15,1,14,3,15,52,,0,0,0,38.28,3,1,0,2,0,1,50,67,113,
1130,Will Weiss,6,115,0,23,16,7,7,15,55,,0,0,0,,0,10,0,5,0,11,33,82,0,
1131,Eric Cooney,11,186,0,11,2,9,13,15,40,,0,0,0,,0,6,0,3,0,7,76,110,0,
1132,Michael Arbutine,12,233,209,15,5,10,7,15,57,,1313,377,936,35.89,3,5,0,2,0,3,115,118,237,
1133,Marc Huber,13,57,0,14,11,3,14,15,102,98.08,0,0,0,,0,12,0,1,0,13,18,39,0,
1134,Matt Penman,8,62,0,13,2,11,4,15,17,,0,0,0,,0,1,0,1,0,1,11,51,0,
1135,Dustin Sullivan,26,342,284,28,7,21,4,15,181,91.41,0,0,0,42.61,11,14,0,3,0,2,240,102,199,
1136,Gabe Webster,6,101,105,16,9,7,4,15,45,,470,128,342,50.48,4,3,0,2,0,0,39,62,105,
1137,Bill Barnes,11,125,0,15,5,10,13,15,43,,0,0,0,,0,3,0,10,0,0,12,113,0,
1138,Aly Lenon,13,278,358,38,26,12,4,15,223,87.11,0,0,0,46.93,12,26,1,1,0,5,222,56,279,
1139,Roy Matthews,11,203,134,11,3,8,6,15,44,,0,0,0,39.55,6,1,0,1,0,0,9,194,157,
1140,Patrick Church,9,156,197,22,2,20,11,15,53,,0,0,0,33.5,5,6,1,12,0,0,98,58,161,
1141,Eric Alexander,11,112,0,16,10,6,5,15,43,,0,0,0,,0,4,0,2,0,0,4,108,0,
1142,Brett Sawyer,11,171,119,9,0,9,12,15,19,,0,0,0,26.05,1,4,0,2,0,3,18,153,149,
1143,Clint McSherry,15,230,209,27,18,9,3,15,171,91.44,249,189,60,45.93,19,12,0,3,0,9,106,124,191,
1144,Ywan Cohonner,8,128,70,8,2,6,8,15,21,,478,99,379,,5,0,0,1,1,0,1,127,130,
1145,Cody Johnston,10,199,259,24,18,6,0,15,342,96.88,0,0,0,58.3,25,7,1,2,0,0,173,26,231,
1146,Jack Barrow,16,159,163,16,2,14,3,15,104,97.2,0,0,0,50.31,4,3,0,1,0,0,105,54,183,
1147,Quinn Hunziker,10,160,211,29,12,17,5,15,110,83.33,0,0,0,38.86,12,18,0,1,0,0,121,39,168,
1148,Matt Stavinga,13,151,0,17,10,7,10,15,75,,0,0,0,,0,9,0,3,0,4,56,95,0,
1149,John Siemer,20,313,124,34,10,24,11,15,390,94.89,0,0,0,29.84,5,21,0,9,0,9,148,165,123,
1150,Daniel Bellissimo,13,194,141,14,5,9,11,15,38,,0,0,0,39.01,1,8,0,2,0,2,30,164,158,
1151,Matt Miller,10,177,142,15,9,6,4,15,124,95.38,991,752,239,40.85,6,4,0,0,0,0,24,153,223,Defender
1152,Kyle Gill,8,133,138,22,7,15,4,15,92,,0,0,0,47.1,11,6,1,5,0,1,67,66,126,
1153,Dan Rowan,8,117,117,9,3,6,14,15,38,,0,0,0,47.01,6,5,0,3,0,0,13,104,109,
1154,Felipe Delgado,21,292,224,24,11,13,9,15,101,86.32,0,0,0,40.63,10,13,0,5,0,8,48,244,257,
1155,Ryan Weaver,25,408,498,46,31,15,6,15,515,92.29,2841,1947,894,49.2,28,36,0,1,0,1,326,82,448,Handler
1156,Nick Stuart,3,81,101,17,8,9,6,15,39,,0,0,0,53.47,6,6,0,2,0,0,63,18,68,
1157,Mathieu Bordeleau,12,230,257,16,5,11,14,15,107,89.92,0,0,0,39.69,12,12,0,3,0,2,129,101,235,
1158,Sam Peezick,16,199,224,22,4,18,7,15,41,,0,0,0,30.36,8,8,0,6,0,1,128,71,184,
1159,Peter Zhou,10,105,84,13,3,10,4,15,42,,0,0,0,,1,2,0,0,0,0,6,99,88,
1160,Jonathan Bain,48,720,519,61,36,25,34,15,662,92.72,0,0,0,26.01,20,70,0,10,0,3,257,463,505,
1161,Ted Landis,13,203,252,22,3,19,2,14,48,,0,0,0,37.7,1,3,0,7,0,0,143,60,182,
1162,Danny Karlinsky,17,454,568,46,34,12,4,14,539,93.09,0,0,0,51.76,56,31,1,5,0,4,371,83,413,
1163,Trevor Knechtel,22,500,539,49,34,15,11,14,506,90.68,0,0,0,40.63,35,41,0,5,0,11,272,228,472,
1164,Nick Ladas,10,146,121,14,7,7,5,14,35,,0,0,0,43.8,4,3,0,2,0,20,22,124,114,Defender
1165,Rob Smith,9,152,45,18,5,13,5,14,67,,0,0,0,,1,6,0,3,0,0,118,34,29,
1166,Dan Latz,16,177,189,29,21,8,14,14,245,88.77,0,0,0,31.22,15,26,0,3,0,0,120,57,140,
1167,Ryan Lacy,15,164,94,12,5,7,8,14,28,,15,0,15,,2,5,0,1,0,0,4,160,140,
1168,Eric Brinkman,12,230,189,18,10,8,8,14,97,87.39,0,0,0,31.22,5,11,0,1,0,5,73,157,196,
1169,Dean Bullock,10,169,85,5,0,5,11,14,26,,639,123,516,,1,2,0,0,0,0,3,166,171,
1170,Jeese Rohowetz,12,92,0,9,0,9,5,14,21,,0,0,0,,0,0,0,0,0,0,3,89,0,
1171,Thomas Echols,9,173,145,23,12,11,2,14,101,90.18,0,0,0,42.07,4,10,0,1,0,17,58,115,157,Defender
1172,Steve Willis,15,226,0,10,0,10,8,14,56,,0,0,0,,0,1,0,3,0,0,98,128,0,
1173,Garrett Santi,19,199,139,24,6,18,7,14,92,88.46,201,58,143,46.04,4,12,1,5,0,90,47,152,200,Defender
1174,Rafe Steinhauer,10,86,0,30,16,14,6,14,146,92.99,0,0,0,,0,17,0,5,0,0,47,39,0,
1175,Kennith Taylor,11,146,82,11,5,6,7,14,19,,584,144,440,,3,3,0,1,0,2,6,140,175,
1176,Victor Bautista,17,213,155,14,2,12,4,14,29,,0,0,0,41.29,2,3,0,1,0,5,16,197,170,
1177,Jake Steen,7,140,184,22,2,20,1,14,58,,1665,250,1415,47.28,6,4,0,5,0,0,137,3,166,Cutter
1178,Nate Little,11,140,85,12,2,10,9,14,15,,582,116,466,,3,4,0,3,0,0,10,130,153,Cutter
1179,Nicolas Vanasse,18,251,322,34,20,14,5,14,159,89.83,0,0,0,38.2,14,17,0,8,0,2,176,75,249,
1180,Connor Newell,11,252,316,32,15,17,3,14,180,89.55,2705,949,1756,51.58,25,20,0,1,0,0,251,1,289,Hybrid
1181,Frank Weng,14,117,90,11,6,5,5,14,43,,18,14,4,,4,2,0,0,0,0,36,81,96,
1182,Joseph Kozicky,10,39,0,15,4,11,5,14,52,,0,0,0,,0,6,0,0,0,0,18,21,0,
1183,Cory Broyles,20,303,289,13,7,6,10,14,179,94.71,0,0,0,40.48,10,8,1,1,0,0,94,209,272,
1184,Alexandre Fall,11,137,96,6,1,5,11,14,27,,0,0,0,,2,2,0,1,0,0,10,127,125,
1185,Dean Ramsey,8,114,69,9,2,7,5,14,17,,515,129,386,,1,0,0,0,0,88,6,108,145,
1186,Bill Finn,9,123,0,12,7,5,5,14,155,98.1,0,0,0,,0,3,0,0,0,0,53,70,0,
1187,Adrian King,23,436,628,42,31,11,10,14,693,92.65,0,0,0,39.81,37,35,0,3,0,22,357,79,500,
1188,Michael Groeber,11,55,0,22,17,5,5,14,81,,0,0,0,,0,12,0,1,0,0,29,26,0,
1189,Brian Williams,20,338,456,48,22,26,5,14,234,87.97,0,0,0,34.21,11,28,0,11,0,5,276,62,354,
1190,Nico Ranabhat,11,154,132,14,6,8,6,14,33,,965,233,732,55.3,5,5,0,1,0,0,28,126,182,
1191,Matt Harvey,9,131,137,14,7,7,9,14,35,,0,0,0,33.58,5,9,1,0,0,43,30,101,116,
1192,Jon Wenger,18,240,177,20,11,9,8,14,56,,0,0,0,35.59,4,12,0,2,0,65,22,218,204,
1193,Andrew Goldstein,8,135,141,15,7,8,4,14,62,,0,0,0,52.48,5,5,0,0,0,1,91,44,120,
1194,Kyle Cantal,35,509,365,13,3,10,15,14,98,86.73,178,92,86,30.41,8,12,0,2,0,0,35,474,519,
1195,Owen Murphy,10,215,294,26,17,9,7,14,386,95.54,0,0,0,45.92,27,17,0,2,0,0,203,12,221,
1196,Nicholas Dacquisto,14,229,178,11,3,8,6,14,42,,0,0,0,37.08,2,2,1,1,0,0,31,198,206,
1197,Danny On,18,300,251,25,13,12,2,14,162,91.53,0,0,0,40.64,15,13,0,0,0,1,158,142,241,
1198,Jake Baumer,11,112,81,7,3,4,12,14,28,,150,63,87,,1,5,0,0,0,0,20,92,103,Defender
1199,Sam Feder,25,258,129,16,9,7,4,14,73,,724,234,490,51.16,6,5,0,1,0,1,2,256,289,Cutter
1200,Michael Weber,15,222,237,26,13,13,6,14,186,91.63,0,0,0,25.74,7,11,0,7,0,0,153,69,173,
1201,Michael Caldwell,15,318,394,41,28,13,1,13,104,81.25,0,0,0,53.05,14,22,0,7,0,1,282,36,257,
1202,Josh Norris,10,204,277,22,17,5,2,13,321,95.54,0,0,0,46.57,17,10,1,1,0,0,185,19,204,
1203,Josh Kautz,6,115,126,10,0,10,3,13,41,,0,0,0,59.52,4,0,0,0,0,0,69,46,105,Defender
1204,Jack Kern,9,137,103,13,1,12,6,13,23,,0,0,0,33.01,3,4,0,2,0,0,31,106,146,
1205,Ashton Hoffman,15,168,202,17,11,6,3,13,172,96.09,1559,1336,223,39.11,7,7,0,0,0,10,143,25,188,
1206,Henry Goldenberg,12,133,130,17,12,5,3,13,122,95.31,1191,780,411,49.23,6,5,1,2,0,2,65,68,168,
1207,Quint Wharton,12,191,164,17,10,7,4,13,76,,0,0,0,36.59,2,6,0,2,0,0,49,142,173,
1208,Austin Raymond,8,38,0,12,3,9,4,13,25,,0,0,0,,0,3,0,0,0,0,21,17,0,
1209,Jace Bruner,4,41,30,8,0,8,5,13,11,,382,8,374,,1,0,0,0,0,0,0,41,51,
1210,Alex Evangelides,7,135,145,19,10,9,5,13,82,,0,0,0,42.76,11,7,1,4,0,1,58,77,124,
1211,Trey Taliaferro,9,161,228,28,16,12,8,13,121,87.68,0,0,0,35.96,10,15,2,8,0,0,145,16,180,Cutter
1212,Robert Johnson,19,242,88,22,13,9,9,13,232,94.31,0,0,0,,3,13,0,5,0,22,148,94,83,
1213,Aidan Lopez-Escarez,10,146,95,15,5,10,10,13,32,,1118,393,725,,6,11,0,1,0,26,7,139,154,Cutter
1214,Harrison Schwarzer,12,104,26,15,6,9,6,13,25,,0,0,0,,1,5,0,3,0,14,24,80,26,
1215,Kevin Healey,6,91,107,16,0,16,2,13,34,,907,124,783,68.22,6,3,0,2,0,0,82,9,100,
1216,Ethan Bloodworth,14,241,130,13,10,3,7,13,87,,971,447,524,52.31,2,6,0,1,0,1,4,237,283,Handler
1217,Peter Anderson,16,265,355,29,14,15,4,13,100,84.03,0,0,0,46.48,13,16,2,4,0,0,226,39,275,
1218,Tristan Yarter,18,233,154,16,10,6,12,13,98,88.29,965,542,423,40.26,2,13,0,2,0,38,47,186,242,Cutter
1219,Ben Levinsky,22,326,217,12,5,7,13,13,89,89.0,506,167,339,45.62,8,9,0,3,0,6,48,278,304,
1220,Drew Kim,10,168,204,20,14,6,1,13,135,93.1,0,0,0,55.39,12,8,0,0,0,0,145,23,138,
1221,Michael Venezia,6,140,200,20,8,12,4,13,82,,0,0,0,46.5,13,8,0,3,0,0,125,15,125,
1222,Samuel Henderson,10,48,0,15,14,1,9,13,66,,0,0,0,,0,9,0,2,0,0,28,20,0,
1223,Joshua Tan,24,299,255,13,4,9,8,13,55,,0,0,0,38.04,7,2,0,6,0,1,66,233,233,
1224,Matt Burkhardt,33,653,818,67,48,19,19,13,806,91.07,0,0,0,42.3,41,66,1,7,0,132,418,235,610,Handler
1225,Joe Santosus,28,380,233,40,26,14,21,13,693,93.65,0,0,0,38.2,10,44,3,4,0,0,184,196,202,
1226,Ryan Lepore,10,147,107,15,5,10,4,13,37,,0,0,0,50.47,5,3,0,3,0,0,31,116,125,
1227,Alex Simmons,7,179,170,29,24,5,3,13,197,90.37,0,0,0,44.12,20,17,0,2,0,19,53,126,154,
1228,Duncan Fitzgerald,11,183,110,14,5,9,5,13,104,92.04,1120,713,407,57.27,6,5,0,1,0,1,0,183,213,
1229,Brett Anderson,23,340,279,24,15,9,10,13,120,86.96,0,0,0,35.84,9,18,0,3,0,12,129,211,271,
1230,Jacob Sames,11,201,264,16,9,7,6,13,305,96.83,2538,1633,905,48.86,22,6,0,3,0,0,200,1,220,
1231,Brice Dunn,12,187,145,8,4,4,12,13,38,,0,0,0,25.52,4,5,0,2,0,2,34,153,199,Cutter
1232,Danny Schmitt,9,134,87,9,2,7,6,13,27,,0,0,0,,6,1,0,1,0,0,6,128,115,
1233,Michael Zhou,19,303,215,21,13,8,6,13,81,,0,0,0,41.4,3,9,0,5,0,78,17,286,252,
1234,Pierre Lemerle,11,162,121,15,7,8,5,13,45,,0,0,0,33.06,8,7,0,0,0,19,19,143,141,
1235,Ryan James,10,134,107,9,2,7,6,13,36,,0,0,0,46.73,11,2,0,0,0,0,11,123,100,
1236,Logan Diehl,9,141,88,8,0,8,7,13,20,,433,17,416,,2,1,0,1,0,0,37,104,134,
1237,David Nester,6,91,106,16,10,6,3,13,60,,1243,409,834,58.49,7,4,0,2,0,0,75,16,81,
1238,Jordan Kinde,21,383,423,48,35,13,9,13,322,87.26,1241,813,428,34.28,17,39,0,5,0,22,254,129,473,
1239,Percy Stogdon,9,177,222,30,12,18,5,13,103,83.06,0,0,0,40.09,9,21,1,1,0,0,132,45,176,
1240,Jeff Meyers,9,33,0,11,4,7,7,13,37,,0,0,0,,0,5,0,0,0,0,17,16,0,
1241,Christopher Johnson,7,91,56,4,0,4,9,13,7,,0,0,0,,1,0,0,0,0,0,12,79,85,
1242,Robert Cahill,11,253,321,44,34,10,8,13,380,89.83,0,0,0,49.84,31,38,0,1,0,6,195,58,227,
1243,Jake McGoogan,8,128,146,13,7,6,5,13,98,95.15,0,0,0,50.68,6,3,0,2,0,1,69,59,124,
1244,Jon Ginsberg,13,242,0,20,14,6,14,12,349,95.36,0,0,0,,0,17,0,5,0,0,205,37,0,
1245,Xavier Charles,15,121,82,8,2,6,4,12,12,,15,0,15,,1,0,0,0,0,0,10,111,105,
1246,John Stacey,6,92,69,14,10,4,2,12,17,,0,0,0,,2,1,0,3,0,0,19,73,80,
1247,Nathan Sany,8,146,141,13,6,7,2,12,54,,0,0,0,55.32,5,3,0,0,0,2,81,65,113,
1248,Nicolas Brochu,22,366,443,26,13,13,12,12,275,88.71,0,0,0,37.25,25,26,0,0,0,107,193,173,357,
1249,Bryan Yue,30,378,295,15,6,9,9,12,101,90.99,175,158,17,41.69,3,7,0,5,0,5,28,350,369,
1250,Andrew Bosco,9,96,0,27,16,11,2,12,137,89.54,0,0,0,,0,16,0,1,0,0,49,47,0,
1251,Steven Thor,9,28,0,9,5,4,5,12,13,,0,0,0,,0,2,0,0,0,0,14,14,0,
1252,Ryan Werkmeister,18,244,198,19,7,12,7,12,131,90.97,0,0,0,37.37,10,12,0,2,0,45,64,180,231,
1253,Alon Brown,13,237,0,31,20,11,15,12,101,75.94,0,0,0,,0,32,0,2,0,221,31,206,0,
1254,Brian Gfroerer,22,274,201,11,2,9,12,12,68,,292,86,206,33.33,5,9,0,2,0,2,56,218,278,
1255,Tim Lootens,19,219,163,17,7,10,6,12,109,90.08,240,174,66,47.85,6,11,0,0,0,1,78,141,216,
1256,Maxwell Rick,47,1060,1136,133,81,52,36,12,1333,88.75,180,163,17,37.68,74,144,0,13,0,88,740,320,938,
1257,Reese Bowman,16,303,209,18,10,8,9,12,178,92.23,1513,936,577,48.33,15,13,0,2,0,87,61,242,291,
1258,Daniel Butler,15,132,99,10,0,10,6,12,26,,0,0,0,,1,3,0,1,0,3,16,116,103,
1259,Chris Walsh,9,178,213,27,13,14,3,12,254,93.38,3052,1972,1080,52.58,14,16,0,2,0,0,172,6,192,
1260,Dana Dunbar,13,205,314,26,11,15,2,12,125,89.29,0,0,0,34.39,10,11,1,5,0,0,183,22,216,
1261,Tannor Johnson,4,92,111,21,11,10,1,12,113,91.13,2048,892,1156,55.86,14,9,0,1,0,0,85,7,102,
1262,Josh Duncan,11,123,86,5,1,4,7,12,6,,0,0,0,,0,0,0,0,0,4,6,117,91,
1263,Michael Dehnbostel,13,160,126,6,2,4,11,12,22,,31,22,9,45.24,5,4,0,1,0,1,11,149,152,Defender
1264,Matt Dilworth,14,180,175,12,3,9,6,12,50,,0,0,0,28.0,3,5,0,1,0,0,60,120,162,
1265,Austin Lee,23,203,169,15,4,11,5,12,42,,0,0,0,40.24,4,5,0,3,0,0,32,171,165,
1266,David Stoddard,10,39,0,18,8,10,5,12,74,,0,0,0,,0,8,0,3,0,0,18,21,0,
1267,Brian Roach,21,249,167,18,10,8,5,12,59,,584,290,294,45.51,5,9,0,2,0,38,57,192,221,Cutter
1268,Jake Berzoff-Cohen,12,166,0,19,12,7,10,12,130,90.91,0,0,0,,0,13,0,4,0,96,55,111,0,
1269,Jasper Tom,15,216,152,8,3,5,8,12,133,97.08,879,587,292,44.74,11,3,0,1,0,1,18,198,244,
1270,Austin Barden,8,133,131,18,4,14,3,12,47,,1273,304,969,45.04,5,7,0,2,0,63,57,76,152,Defender
1271,Cullen Raasch,4,65,73,12,3,9,4,12,19,,0,0,0,,0,3,1,1,0,0,42,23,57,
1272,Ben Green,9,152,93,6,0,6,10,12,27,,445,-45,490,,3,2,0,2,0,1,6,146,161,
1273,Steven Wartinbee,8,114,147,18,12,6,2,12,119,95.2,1531,736,795,59.86,9,5,0,3,0,0,112,2,140,
1274,Brian Rathunde,13,137,122,14,6,8,6,12,27,,0,0,0,36.07,4,7,0,1,0,0,9,128,130,
1275,Joe Taris,11,63,0,23,16,7,11,12,136,87.74,0,0,0,,0,19,0,3,0,0,24,39,0,
1276,Josh Beaulieu,20,124,67,19,7,12,5,12,67,,0,0,0,,0,9,0,3,0,0,47,77,79,
1277,Jon Greenberg,12,212,193,21,20,1,5,12,163,91.57,0,0,0,40.41,4,13,0,1,0,2,44,168,219,
1278,Alexander Taylor,10,181,196,13,1,12,5,11,154,95.65,0,0,0,51.53,14,5,0,2,0,0,107,74,166,
1279,Dustin Rooffener,24,233,194,22,5,17,3,11,52,,0,0,0,43.81,8,8,0,6,0,0,35,198,193,
1280,Solomon Rueschemeyer-Bailey,14,266,266,23,13,10,0,11,426,97.48,3176,3210,-34,63.16,28,11,0,1,0,0,190,76,304,Handler
1281,Breton Dietrich,14,206,0,27,22,5,13,11,159,86.41,0,0,0,,0,25,0,4,0,4,39,167,0,
1282,Lucas Murphy,7,42,0,11,9,2,6,11,42,,0,0,0,,0,6,0,0,0,0,21,21,0,
1283,Kevin Soneson,8,116,136,5,2,3,14,11,24,,0,0,0,20.59,0,5,0,3,0,0,26,90,113,
1284,Jonathan Cursi,9,72,0,10,1,9,3,11,8,,0,0,0,,0,1,0,1,0,0,49,23,0,
1285,Michael Meilstrup,9,31,0,9,4,5,2,11,0,,0,0,0,,0,0,0,0,0,0,14,17,0,Handler
1286,Robert Halvorsen,6,72,55,8,0,8,4,11,10,,0,0,0,,0,0,0,1,0,0,17,55,62,
1287,Nick Kaczmarek,7,116,82,10,7,3,1,11,66,,0,0,0,,9,0,0,0,0,0,13,103,96,
1288,Matthew Ballman,7,84,56,8,1,7,3,11,10,,31,11,20,,1,0,0,0,0,0,27,57,71,Cutter
1289,Olivier Drouin,10,140,146,11,3,8,4,11,30,,0,0,0,47.26,5,2,0,2,0,0,74,66,124,
1290,Liam McDonald,5,53,42,9,3,6,4,11,23,,505,228,277,,1,2,0,0,0,0,4,49,59,
1291,Gabe Fruchter,6,108,99,9,3,6,7,11,6,,0,0,0,,0,3,0,2,0,1,39,69,93,
1292,Ray Tetreault,5,83,55,9,4,5,4,11,27,,621,140,481,,2,1,0,1,0,0,17,66,94,
1293,Reid Martin,11,156,121,13,6,7,3,11,99,99.0,975,437,538,61.16,8,1,0,4,0,1,54,102,168,
1294,Ryan Bigley,11,192,208,20,16,4,8,11,150,90.36,0,0,0,40.38,17,15,0,2,0,4,89,103,185,
1295,Daniel Sluka,14,174,156,8,2,6,9,11,24,,0,0,0,27.56,2,5,0,1,1,1,24,150,134,
1296,Ian Chiles,9,141,132,12,5,7,5,11,53,,0,0,0,40.15,3,3,0,3,0,0,22,119,143,
1297,Tony Pehrson,13,217,265,17,3,14,7,11,67,,0,0,0,22.64,3,9,0,4,0,0,148,69,158,
1298,Dustin Travaglini,69,1156,973,68,51,17,33,11,888,90.15,1158,1054,104,38.64,47,88,0,2,0,728,306,850,1180,
1299,Will W,9,128,198,22,12,10,5,11,161,90.45,0,0,0,35.86,13,15,0,1,0,2,111,17,135,
1300,Jesse Ellwood,9,37,0,15,5,10,4,11,37,,0,0,0,,0,6,0,2,0,0,17,20,0,
1301,Evan Meccarello,9,136,83,4,1,3,11,11,25,,0,0,0,,1,2,0,2,0,0,24,112,96,
1302,Christian Foster,3,72,67,14,9,5,3,11,51,,0,0,0,,4,6,0,0,0,51,17,55,65,
1303,Thomas Horvath,18,120,70,11,2,9,7,11,32,,0,0,0,,0,4,0,3,0,0,23,97,76,
1304,Oliver Telfer,12,222,207,18,8,10,1,11,117,95.12,0,0,0,47.83,11,5,0,3,0,53,96,126,194,
1305,Sam Ellison,11,134,107,5,1,4,9,11,21,,0,0,0,30.84,0,3,0,0,0,0,31,103,150,
1306,Alex Brouwer,17,141,95,10,0,10,3,11,21,,315,49,266,,2,0,0,2,0,0,12,129,158,
1307,Fred Parenteau,22,318,313,17,10,7,15,11,168,88.89,0,0,0,37.38,11,18,0,3,0,33,111,207,322,
1308,Nick Heid,14,231,239,28,26,2,9,11,189,87.1,0,0,0,39.75,17,23,0,3,0,41,70,161,224,
1309,Nolan Walsh,12,211,180,14,7,7,3,11,43,,0,0,0,37.78,8,4,1,2,0,12,59,152,183,
1310,Biz Schlaefer,3,37,38,12,7,5,1,11,28,,479,217,262,,2,0,0,2,0,3,3,34,52,
1311,Austin Lien,53,1050,1213,74,55,19,23,11,1915,94.66,0,0,0,40.31,60,76,1,10,0,11,837,213,920,
1312,Ian McCosky,10,179,115,9,7,2,4,11,53,,885,161,724,53.04,5,0,0,2,0,1,23,156,202,
1313,Alex Trautman,10,133,82,13,4,9,0,11,23,,0,0,0,,3,1,0,1,0,1,31,102,121,
1314,Kieran Charnock,16,155,88,10,6,4,4,11,25,,158,38,120,,1,2,0,1,0,0,17,138,158,
1315,Alex Grintsvayg,10,42,0,13,5,8,8,11,73,,0,0,0,,0,9,0,1,0,0,21,21,0,
1316,Mark Philipson,12,245,259,15,7,8,6,11,320,97.26,0,0,0,40.15,16,6,0,4,0,1,160,85,244,
1317,Tim Gehret,3,52,51,13,8,5,1,11,13,,0,0,0,,1,3,0,0,0,10,28,24,38,
1318,Ryan Forster,50,890,1083,108,58,50,19,11,1044,89.92,0,0,0,36.66,64,98,0,18,0,17,711,179,834,
1319,Taylor Pope,8,147,86,12,4,8,5,11,22,,0,0,0,,4,6,2,0,0,109,4,143,120,
1320,Griffin Binkley,8,203,298,15,5,10,9,11,139,91.45,0,0,0,34.23,10,9,0,4,0,0,170,33,209,
1321,Eric St-Amant,12,203,236,20,13,7,4,11,101,87.83,0,0,0,35.17,8,8,0,5,0,0,135,68,202,
1322,Kenny Calello,8,113,0,17,12,5,4,11,120,93.02,0,0,0,,0,9,0,1,0,0,71,42,0,
1323,Isaac Conley,10,272,357,41,26,15,13,11,236,81.66,0,0,0,31.65,22,40,0,3,0,6,203,69,244,
1324,Bryan Conklin,14,211,234,17,7,10,4,11,63,,0,0,0,53.85,8,8,0,2,0,0,163,48,163,
1325,James Dahl,11,210,167,11,9,2,6,10,182,96.3,0,0,0,37.13,12,6,0,1,0,0,52,158,183,
1326,Johnnie Lynch,15,136,102,10,2,8,9,10,24,,0,0,0,43.14,5,3,1,6,0,0,5,131,133,
1327,Kegan Carroll,16,192,133,12,2,10,9,10,39,,0,0,0,29.32,9,5,0,6,0,0,31,161,139,Defender
1328,Will Herold,12,222,152,13,7,6,4,10,61,,0,0,0,48.68,3,4,0,3,0,106,11,211,211,
1329,Gavin Sing,10,89,110,12,1,11,4,10,20,,0,0,0,34.55,1,4,0,2,0,0,27,62,95,
1330,Andrew Pebley,7,110,83,11,4,7,1,10,32,,0,0,0,,2,2,0,0,0,0,18,92,99,
1331,Devin Cox,13,169,139,7,3,4,10,10,31,,0,0,0,27.34,2,5,0,2,0,8,33,136,163,
1332,Elliott Lamborn,10,152,133,6,0,6,10,10,39,,0,0,0,21.8,4,4,0,2,0,5,33,119,155,
1333,Jeff Trosvig,13,210,0,21,17,4,7,10,268,94.7,0,0,0,,0,15,0,3,0,62,109,101,0,
1334,Colin Green,14,191,166,16,16,0,7,10,127,91.37,0,0,0,43.98,12,12,0,1,0,1,32,159,164,
1335,Kevin Versteeg,14,187,130,6,1,5,11,10,18,,143,5,138,39.23,0,4,0,3,0,0,14,173,216,
1336,Jose Maldonado,10,164,102,14,4,10,6,10,32,,0,0,0,50.0,6,9,0,1,0,0,12,152,125,
1337,Michael Brisbois,12,172,143,16,8,8,2,10,68,,1136,218,918,42.66,5,7,0,1,0,1,65,107,188,Cutter
1338,Chris Lung,8,144,98,10,10,0,6,10,92,92.0,1015,1006,9,,8,6,0,0,0,13,36,108,141,
1339,Wyatt Mekler,6,126,149,19,9,10,1,10,164,94.25,0,0,0,41.61,13,8,1,2,0,0,81,45,137,Handler
1340,Dan Gillick,6,79,100,10,2,8,4,10,38,,0,0,0,46.0,7,4,0,0,0,0,31,48,79,
1341,Cole Davis-Brand,5,93,96,17,10,7,1,10,105,92.92,1540,850,690,,10,7,0,1,0,0,66,27,91,
1342,Kenny Lane III,9,130,138,15,9,6,2,10,115,95.04,1244,721,523,44.2,7,4,0,3,0,18,76,54,155,Hybrid
1343,Daniel Donovan,14,375,560,65,53,12,13,10,661,89.32,0,0,0,35.71,37,67,0,1,0,13,315,60,400,
1344,Max Trotter,28,602,702,41,25,16,12,10,896,95.62,0,0,0,38.89,47,35,0,8,0,3,356,246,639,Handler
1345,Tristan Grovender,35,602,699,49,39,10,10,10,718,92.88,0,0,0,39.48,47,42,0,7,0,35,324,278,566,Handler
1346,Chris Ginet,20,252,161,9,4,5,6,10,83,,281,228,53,42.24,8,5,0,0,0,7,25,227,240,
1347,Gyorgy Aponte,8,144,112,11,1,10,10,10,27,,0,0,0,38.39,5,11,0,0,0,11,13,131,113,
1348,Tyler Condit,11,146,116,11,7,4,3,10,22,,0,0,0,31.9,1,4,0,0,0,29,30,116,122,
1349,Jason Best,12,264,268,19,12,7,13,10,253,90.36,0,0,0,38.06,12,22,0,0,0,29,110,154,252,
1350,Jordan Perry,7,97,78,11,10,1,3,10,78,,0,0,0,,9,4,0,0,0,0,23,74,79,
1351,Cam Wariner,4,73,31,4,3,1,6,10,25,,295,103,192,,4,0,0,0,0,0,2,71,76,
1352,Dave Abbott,16,325,146,29,24,5,28,10,324,86.63,0,0,0,28.08,5,47,0,0,0,146,90,235,139,
1353,Ethan Fortin,33,613,690,46,34,12,12,10,829,93.04,456,237,219,41.16,44,47,0,1,0,97,334,279,682,Handler
1354,Matt Russnogle,14,198,105,8,1,7,7,10,18,,0,0,0,29.52,3,3,0,2,0,1,31,167,139,
1355,Mathieu Bosser,8,119,133,15,9,6,3,10,144,94.12,0,0,0,48.12,13,8,0,0,0,0,90,29,119,
1356,Rusty Ingold-Smith,5,97,98,13,8,5,2,10,71,,0,0,0,,8,5,0,0,0,1,20,77,92,
1357,Jean Guillemette,9,124,85,8,2,6,4,10,37,,0,0,0,,0,2,0,0,0,0,23,101,94,
1358,Jon Neeley,29,561,749,52,35,17,10,10,725,92.12,0,0,0,49.53,60,47,2,5,0,5,450,111,554,
1359,Jeremy Kharrazi,22,364,278,21,14,7,7,10,173,90.58,0,0,0,32.01,11,16,0,2,0,54,37,327,336,
1360,Allan Michel,27,301,228,11,4,7,9,10,67,,493,86,407,29.82,9,6,0,4,0,0,26,275,325,Cutter
1361,Peter Burt,8,101,83,9,3,6,5,10,27,,0,0,0,,3,4,0,0,0,8,23,78,111,Cutter
1362,Alex Jirele,6,56,58,10,2,8,1,10,14,,0,0,0,,3,0,0,1,0,1,34,22,52,Cutter
1363,Matt Ellis,17,185,117,13,6,7,7,10,65,,123,108,15,44.44,4,9,0,1,0,11,18,167,184,Cutter
1364,Kyle Terriere,12,162,102,4,1,3,10,10,25,,0,0,0,38.24,6,4,0,0,0,0,18,144,120,
1365,Ben Beehner,11,166,117,8,2,6,5,10,38,,0,0,0,41.03,4,2,0,1,0,0,14,152,148,
1366,Stephen Moore,11,118,73,4,0,4,10,10,14,,0,0,0,,3,1,0,3,0,0,14,104,91,
1367,Jesse Johnson,16,155,120,8,0,8,6,10,38,,458,96,362,55.0,8,3,2,1,0,0,41,114,164,
1368,Benjamin Law,13,237,329,29,5,24,7,10,93,86.11,0,0,0,24.01,9,14,0,12,0,0,185,52,198,
1369,Evan Boecking,22,491,461,30,24,6,22,10,528,91.99,0,0,0,43.82,41,39,1,3,0,40,212,279,444,
1370,Nick Wetzel,21,404,474,26,6,20,18,10,282,88.96,0,0,0,28.69,19,29,0,5,0,47,185,219,413,
1371,Jesse Jenkins,8,98,56,7,1,6,6,10,16,,0,0,0,,2,2,0,1,0,0,5,93,74,
1372,Ludwig K,7,81,116,13,7,6,2,10,48,,0,0,0,45.69,4,5,0,0,0,0,68,13,87,
1373,Kyle Vezina,5,54,39,6,0,6,4,10,9,,130,8,122,,1,0,0,0,0,0,1,53,64,
1374,Jake Rovner,9,129,103,11,3,8,8,10,16,,0,0,0,39.81,3,7,0,2,0,2,26,103,106,
1375,Joshua Ackley,12,228,304,25,12,13,3,10,428,94.48,0,0,0,50.99,22,17,0,1,0,0,199,29,255,
1376,Jacob Lien,23,419,540,39,25,14,18,10,448,89.24,0,0,0,35.0,24,45,2,2,0,31,200,219,455,
1377,William Anderst,6,102,65,3,1,2,8,10,15,,0,0,0,,3,1,0,0,0,1,10,92,89,
1378,Peter Osseward,13,154,232,26,6,20,4,10,96,86.49,0,0,0,34.48,7,15,0,5,0,0,142,12,163,
1379,Bobby Patterson,24,367,274,20,12,8,12,10,132,85.71,0,0,0,44.89,15,18,0,4,0,54,80,287,329,
1380,Braedan Robinson,13,159,95,7,1,6,6,10,23,,155,29,126,,2,2,0,1,0,0,17,142,163,
1381,Ryan Woodhouse,8,110,51,2,1,1,8,9,11,,227,62,165,,0,1,0,0,0,0,1,109,109,
1382,Adnan Raslan,20,272,231,12,6,6,12,9,92,88.46,127,99,28,28.14,6,11,0,4,0,17,80,192,250,
1383,Ian Ladner,13,133,153,9,4,5,2,9,96,,243,125,118,56.21,10,1,0,1,0,0,108,25,144,Hybrid
1384,Scott Roeder,13,256,346,29,20,9,2,9,223,91.39,0,0,0,57.23,22,18,0,4,0,0,228,28,209,
1385,Alex Mcclure,3,40,27,3,1,2,6,9,7,,171,22,149,,0,0,0,0,1,0,3,37,45,
1386,Kris Harrison,12,170,105,5,4,1,8,9,94,,413,392,21,53.33,7,1,0,3,0,20,7,163,160,
1387,Steve LaCrosse,8,47,0,14,7,7,1,9,31,,0,0,0,,0,3,0,3,0,0,41,6,0,
1388,June Rapisura,11,208,170,13,10,3,4,9,144,92.9,0,0,0,40.59,4,8,0,0,0,1,90,118,195,
1389,Rob Greenberg,23,204,69,17,8,9,17,9,122,84.14,0,0,0,,3,22,0,3,0,20,12,192,92,
1390,Jake Steslicki,5,121,189,19,7,12,4,9,109,89.34,0,0,0,35.45,12,13,0,1,1,0,105,16,132,
1391,Bjarne Laursen,11,238,333,29,15,14,14,9,133,82.61,0,0,0,25.53,10,22,0,12,0,18,165,73,248,
1392,Jacques Perivier,17,260,237,21,14,7,1,9,273,94.46,477,371,106,54.43,21,12,0,1,0,3,147,113,257,
1393,Ian Engler,5,103,116,11,8,3,1,9,163,97.6,2006,1312,694,55.17,12,3,2,0,0,0,92,11,107,
1394,Grayson Sanner,9,102,66,10,2,8,2,9,32,,258,114,144,,2,3,0,0,0,0,4,98,102,Cutter
1395,Scott Heyman,12,201,196,17,7,10,4,9,85,,1555,515,1040,46.94,13,9,0,3,0,0,117,84,231,Cutter
1396,Todd Hershberger,8,150,183,12,3,9,5,9,80,,0,0,0,39.89,9,8,0,0,0,0,122,28,147,
1397,Franklyn Robinson,8,20,0,7,0,7,6,9,33,,0,0,0,,0,4,0,0,0,0,7,13,0,
1398,Raheem Ishaque,6,62,41,4,1,3,6,9,9,,273,62,211,,1,0,0,1,0,0,3,59,68,
1399,Eric Blais,6,88,53,7,3,4,4,9,22,,401,183,218,,0,2,0,0,0,6,2,86,113,
1400,Xavier Klena,16,185,226,7,4,3,11,9,87,,0,0,0,18.14,2,5,0,4,0,1,64,121,212,Cutter
1401,Jared Brody,8,112,85,14,4,10,2,9,24,,0,0,0,,3,5,0,2,0,0,7,105,110,
1402,Adam Choi,5,92,68,11,7,4,1,9,31,,0,0,0,,1,2,0,1,0,15,11,81,75,
1403,Alex Baker,11,159,152,11,7,4,8,9,126,91.97,0,0,0,42.11,14,9,0,1,0,9,39,120,145,
1404,Paul Krenik,3,45,52,8,2,6,1,9,11,,381,92,289,,3,0,0,0,0,0,34,11,46,
1405,Daniel Greeley,9,92,84,6,4,2,5,9,23,,0,0,0,,3,0,0,2,0,2,10,82,89,
1406,Frank Harris,30,503,261,32,22,10,15,9,431,91.51,0,0,0,20.31,4,31,0,7,0,122,189,314,258,
1407,Jasper Lu,10,102,84,5,1,4,7,9,12,,0,0,0,,1,2,0,1,0,3,12,90,66,
1408,Terry Gaither,8,115,79,2,0,2,9,9,26,,290,59,231,,1,1,0,1,0,0,17,98,112,
1409,Einer Lim,11,191,230,17,6,11,2,9,156,93.98,0,0,0,45.65,10,7,0,3,0,4,128,63,170,
1410,Heath Kalaba,22,226,151,10,6,4,9,9,62,,0,0,0,41.06,6,7,0,3,0,1,21,205,193,
1411,James Koerner,12,175,99,7,2,5,4,9,26,,0,0,0,,3,0,0,2,0,0,14,161,136,
1412,Connor Russell,13,176,110,14,5,9,11,9,64,,534,263,271,50.0,7,15,0,1,0,63,24,152,201,Handler
1413,Kevin Terry,12,299,395,49,44,5,9,9,574,89.83,0,0,0,41.27,36,45,1,4,0,19,222,77,300,
1414,Nate Volkman,21,294,242,26,16,10,5,9,481,94.5,0,0,0,51.65,21,21,0,1,0,1,239,55,175,
1415,Ryan Jarvis,18,205,137,8,3,5,7,9,31,,0,0,0,40.88,3,5,0,1,0,3,14,191,159,
1416,Stephen Shaw,9,176,222,12,6,6,8,9,88,,0,0,0,26.58,8,9,1,2,0,0,121,55,168,
1417,Eric Rathbun,5,17,0,6,1,5,8,9,41,,0,0,0,,0,5,0,0,0,0,7,10,0,
1418,Jesse Lieberman,26,489,634,60,50,10,9,9,580,90.2,0,0,0,42.43,46,51,1,9,0,37,338,151,511,Handler
1419,Casey Vaughn,10,138,115,12,4,8,2,9,27,,0,0,0,31.3,2,3,0,2,0,0,9,129,112,
1420,Alex Vlahos,11,165,179,21,6,15,0,9,63,,0,0,0,49.72,8,7,0,5,0,0,81,84,152,
1421,Alex Gilson,20,328,332,22,11,11,12,9,91,81.98,0,0,0,28.31,5,17,0,8,0,30,145,183,283,
1422,Jacob Spiro,15,140,30,7,4,3,3,9,10,,0,0,0,,1,1,0,0,0,1,10,130,36,
1423,Lucas Coniaris,8,164,187,20,7,13,2,9,113,88.98,1547,282,1265,51.34,7,10,0,3,0,0,139,25,179,
1424,Greg Wakeman,20,299,366,40,31,9,14,9,499,91.39,0,0,0,32.24,19,41,0,4,0,1,248,51,269,
1425,Chad Gerber,7,73,61,10,4,6,1,9,20,,0,0,0,,2,1,0,1,0,0,39,34,63,
1426,Matt Wilken,13,107,0,28,20,8,13,9,193,88.13,0,0,0,,0,26,0,6,0,0,27,80,0,
1427,John Best,14,298,313,32,23,9,11,9,373,89.66,0,0,0,43.77,28,32,0,2,0,13,144,154,281,
1428,Drew Wilson,9,134,165,15,9,6,3,9,49,,0,0,0,45.45,4,6,0,3,0,0,72,62,124,
1429,Hayden Austin-Knab,4,68,76,12,7,5,0,9,48,,626,233,393,,5,3,0,0,0,1,53,15,74,
1430,Xavier Ching,11,137,87,2,0,2,9,9,18,,0,0,0,,1,1,0,1,0,0,11,126,108,
1431,Jake Taylor,7,97,124,13,7,6,2,9,146,95.42,1470,1204,266,55.65,14,6,0,0,0,0,97,0,105,
1432,Kevin Guillemette,13,213,178,13,7,6,10,9,58,,0,0,0,39.33,8,14,0,0,0,153,31,182,200,
1433,Mason Cary,7,111,100,11,2,9,0,9,37,,0,0,0,61.0,6,1,0,1,0,0,53,58,100,
1434,Austin Engel,19,264,349,39,32,7,16,9,446,89.56,0,0,0,36.96,27,44,0,2,1,8,194,70,278,
1435,Logan Stagg,11,148,183,9,5,4,6,9,51,,0,0,0,35.52,8,4,0,2,0,0,113,35,129,
1436,Eric Ela,15,246,0,39,22,17,15,9,230,85.82,0,0,0,,0,38,0,7,0,15,134,112,0,
1437,Sam Little,12,232,263,24,13,11,12,9,243,89.34,0,0,0,43.73,23,24,0,3,0,25,139,93,243,
1438,Pete Carr,15,206,250,13,8,5,6,9,265,96.36,0,0,0,40.8,11,8,1,2,0,1,153,53,201,
1439,Dane Lockhart,13,110,93,14,6,8,0,9,53,,0,0,0,,3,1,0,4,0,1,85,25,65,
1440,Jesse Evans,9,105,65,6,3,3,3,9,19,,0,0,0,,2,0,1,0,0,7,10,95,86,
1441,Lionel Wininger,29,459,655,66,46,20,7,9,662,91.18,0,0,0,44.58,38,60,2,4,0,5,414,45,472,
1442,Felix Leonard,7,79,49,8,5,3,2,9,30,,388,276,112,,3,0,0,1,0,0,0,79,90,
1443,Zhi Chen,10,142,94,12,7,5,3,9,59,,0,0,0,,3,6,0,0,0,1,18,124,112,
1444,Leo Pepper,13,185,206,15,5,10,1,9,126,96.92,0,0,0,44.17,10,4,0,3,0,0,91,94,189,
1445,Lu Wang,17,297,0,34,29,5,21,8,365,89.9,0,0,0,,0,40,1,7,0,5,38,259,0,
1446,Cole Friedes,4,74,52,4,0,4,4,8,14,,0,0,0,,2,0,0,0,0,0,12,62,73,
1447,Alex Gareis,9,68,0,7,3,4,4,8,24,,0,0,0,,0,3,0,0,0,0,1,67,0,
1448,Chris Bubernak,7,95,74,7,0,7,4,8,9,,330,57,273,,3,2,0,1,0,1,27,68,95,Hybrid
1449,Steven Naji,32,442,377,19,17,2,7,8,229,92.34,0,0,0,38.73,13,17,0,1,1,18,51,391,413,
1450,Aidan Hayter,8,110,63,4,2,2,5,8,18,,0,0,0,,2,0,0,1,0,0,9,101,83,
1451,Shaun Doherty,7,16,0,5,1,4,8,8,39,,0,0,0,,0,5,0,0,0,0,9,7,0,
1452,Brandon Canonizado,12,166,114,10,5,5,3,8,56,,0,0,0,41.23,4,4,0,1,0,43,42,124,130,
1453,Gary Dixon,28,448,505,50,40,10,10,8,595,92.11,0,0,0,38.22,43,47,4,5,0,2,142,306,495,
1454,Jacob Wham,8,121,81,8,2,6,3,8,26,,616,193,423,,4,2,0,1,0,41,38,83,127,
1455,David Flock,12,125,135,10,2,8,2,8,82,,0,0,0,43.7,3,3,0,1,0,0,81,44,105,
1456,Steve May,13,141,75,6,3,3,6,8,13,,0,0,0,,2,4,0,0,0,0,10,131,112,
1457,Travis Knight,7,101,145,12,0,12,3,8,46,,0,0,0,40.69,4,3,0,4,0,0,93,8,92,
1458,Chris Gallagher,9,48,0,16,12,4,19,8,153,98.08,0,0,0,,0,19,0,8,0,0,29,19,0,
1459,Igor Smola,5,73,52,7,2,5,5,8,21,,0,0,0,,3,4,0,0,0,0,2,71,66,
1460,Rory Gallagher,2,52,63,10,4,6,0,8,24,,0,0,0,,1,2,0,0,0,0,44,8,49,
1461,Ray Mendoza,11,127,90,5,2,3,7,8,32,,103,3,100,,4,4,0,0,1,2,17,110,133,
1462,Austin Bonelli,21,279,113,19,8,11,14,8,161,88.95,0,0,0,31.86,4,18,0,7,0,16,113,166,106,
1463,Gabriel Hage,23,339,332,30,17,13,13,8,310,88.83,0,0,0,28.31,13,31,1,4,0,40,145,194,290,
1464,Eric Dixon,13,119,0,28,18,10,4,8,227,91.16,0,0,0,,0,22,0,2,0,1,94,25,0,
1465,John Serafini,9,42,0,17,9,8,4,8,82,,0,0,0,,0,9,0,4,0,0,25,17,0,
1466,Pete Zaccardi,12,223,249,14,6,8,8,8,231,93.52,1413,1100,313,45.78,9,13,0,1,0,0,167,56,255,
1467,Bennett Wachob,9,85,72,7,4,3,3,8,51,,0,0,0,,0,2,0,0,0,0,27,58,86,
1468,Steven Hightshue,20,223,202,21,10,11,8,8,159,89.33,0,0,0,36.14,13,17,0,4,0,2,64,159,214,
1469,Kevin Chan,9,122,141,9,2,7,2,8,19,,0,0,0,39.72,1,2,0,1,0,0,68,54,101,
1470,Drew Levorsen,13,105,65,7,3,4,3,8,45,,0,0,0,,4,2,0,0,0,0,8,97,102,
1471,Vince Reydams,6,117,130,7,1,6,9,8,27,,0,0,0,23.85,5,4,0,4,0,0,37,80,124,
1472,Nate Kirchhofer,11,166,121,10,5,5,4,8,72,,123,146,-23,44.63,4,4,0,2,0,76,37,129,178,Handler
1473,Dan Miesen,5,99,127,16,8,8,2,8,180,95.24,0,0,0,40.16,8,4,2,6,0,0,66,33,107,
1474,Yi-Min Lin,14,221,222,13,6,7,4,8,80,,0,0,0,35.14,4,7,0,2,0,2,111,110,191,
1475,Jeff Zhao,17,284,286,27,19,8,5,8,309,92.24,643,551,92,42.66,11,22,1,2,0,8,145,139,296,Handler
1476,Neil Narayan,15,131,0,8,0,8,8,8,34,,0,0,0,,0,8,0,0,0,0,27,104,0,
1477,Michael Ng,7,82,69,8,5,3,4,8,37,,0,0,0,,4,3,0,1,0,0,8,74,77,
1478,Aaron Langley,8,73,48,6,2,4,5,8,14,,0,0,0,,0,2,0,1,0,0,5,68,58,
1479,Brett Kolinek,24,486,217,61,38,23,6,8,736,92.58,0,0,0,50.69,8,55,3,4,0,2,301,185,176,
1480,Brendan Adams,13,173,138,9,3,6,8,8,56,,0,0,0,32.61,3,7,0,2,0,84,31,142,155,
1481,Dayne Meyer,12,121,76,5,3,2,5,8,31,,0,0,0,,1,1,0,1,1,0,16,105,103,
1482,Vincent Gamache,32,391,301,21,15,6,10,8,272,94.12,433,417,16,38.87,21,17,2,6,0,15,107,284,372,
1483,Kiran Thomas,6,92,130,12,6,6,1,8,65,,0,0,0,48.46,9,4,0,1,0,0,76,16,95,Cutter
1484,Aubrey Davis,14,253,241,29,17,12,3,8,183,88.83,0,0,0,47.3,8,23,1,1,0,20,122,131,225,
1485,Connor Ughetta,14,188,170,14,8,6,4,8,105,88.98,0,0,0,33.53,4,10,0,0,0,13,26,162,186,
1486,Kenta Kawaguchi,7,66,42,4,2,2,5,8,16,,143,32,111,,0,1,0,0,0,1,0,66,62,
1487,Christian Gaeta,8,123,70,3,0,3,8,8,21,,83,7,76,,3,2,0,1,0,1,14,109,115,
1488,Kevin Lore,47,963,1176,65,48,17,12,8,982,93.08,0,0,0,44.64,71,59,1,10,0,5,712,251,880,
1489,Justin Goodman,14,162,120,8,4,4,6,8,83,,0,0,0,45.0,7,5,0,1,0,41,36,126,140,
1490,Dave Lipson,8,20,0,8,5,3,6,8,43,,0,0,0,,0,5,0,1,0,0,11,9,0,
1491,Jacob Flowers,12,263,238,11,6,5,11,8,164,92.13,0,0,0,33.19,10,13,0,1,0,52,105,158,245,
1492,Dan Williams,24,394,486,39,34,5,14,8,499,89.75,0,0,0,33.54,22,42,0,3,0,136,122,272,454,
1493,Sam Adamson,8,116,76,9,3,6,2,8,26,,0,0,0,,3,1,0,2,0,0,21,95,98,
1494,Kuo Hsun Wang,14,209,157,15,7,8,4,8,74,,0,0,0,45.22,5,11,0,0,0,0,26,183,166,
1495,Taylor Kraemer,5,72,123,10,4,6,3,8,51,,0,0,0,39.84,1,3,0,2,0,0,56,16,99,
1496,Steven Darroh,14,202,154,9,4,5,4,8,50,,0,0,0,48.7,4,5,0,0,0,0,6,196,179,
1497,Spencer Lofink,3,53,70,11,6,5,1,8,32,,504,263,241,,1,3,0,1,0,0,53,0,60,Cutter
1498,Kevin Jay,17,214,137,8,1,7,5,8,57,,426,214,212,40.15,5,4,0,1,0,12,6,208,241,
1499,Jack Krieger,9,147,123,11,3,8,1,7,58,,0,0,0,43.09,7,4,0,1,0,0,34,113,117,
1500,Brandon Adibe,8,137,74,9,3,6,2,7,9,,452,-7,459,,0,1,0,3,0,0,3,134,133,
1501,Rob Wharton,9,38,24,8,3,5,5,7,36,,0,0,0,,0,6,0,0,0,0,24,14,15,
1502,Mike Dirda,11,145,99,9,1,8,4,7,19,,0,0,0,,1,4,0,2,0,0,13,132,124,
1503,Jacob Lane,14,159,145,9,4,5,4,7,77,,7,0,7,37.93,4,4,0,2,0,0,61,98,158,
1504,Sam Cooper,11,135,112,9,6,3,6,7,91,91.0,0,0,0,42.86,7,6,0,2,0,0,24,111,143,
1505,Brad Bolliger,7,86,101,10,3,7,3,7,52,,0,0,0,48.51,4,3,0,3,0,7,43,43,101,
1506,Matt Mason,5,59,36,5,3,2,4,7,17,,0,0,0,,2,1,0,1,0,0,3,56,51,
1507,Danny Dennin,27,325,92,29,14,15,14,7,127,84.11,0,0,0,,5,22,1,14,0,6,80,245,85,
1508,Jorge Delgado,3,31,25,5,0,5,3,7,11,,283,30,253,,1,1,0,0,0,0,16,15,29,
1509,Stephane Mance,6,74,114,15,6,9,3,7,63,,0,0,0,34.21,7,7,0,4,0,0,11,63,99,
1510,Richard Lange,8,125,110,5,0,5,6,7,27,,0,0,0,21.82,5,1,0,3,0,0,29,96,108,
1511,Sam Pickel,13,202,144,18,11,7,5,7,91,83.49,0,0,0,39.58,5,15,0,1,0,2,31,171,164,
1512,Daniel Garlock,12,186,136,12,9,3,11,7,141,89.24,1533,1147,386,56.62,16,14,0,2,0,87,28,158,191,
1513,Dane Warner,14,171,133,9,2,7,9,7,54,,237,106,131,33.08,6,5,0,6,0,0,24,147,197,
1514,Drew Otterlei,10,122,111,16,9,7,3,7,108,87.8,0,0,0,39.64,6,12,0,0,0,22,33,89,122,Handler
1515,Luis Alejandro Royo Romero,5,105,96,8,2,6,5,7,37,,0,0,0,,1,2,1,4,0,0,41,64,86,Handler
1516,Ben Weyers,7,29,0,9,2,7,1,7,22,,0,0,0,,0,3,0,0,0,0,12,17,0,
1517,Fred Bredard,5,59,53,9,0,9,2,7,3,,0,0,0,,1,2,0,2,0,0,9,50,57,
1518,Carlos Rodriguez,9,69,0,5,2,3,6,7,12,,0,0,0,,0,3,0,1,0,1,16,53,0,
1519,Basile Limoges,19,223,259,15,6,9,5,7,134,91.16,487,168,319,40.15,6,9,0,4,0,1,137,86,243,
1520,Brett Robinson,5,59,51,9,3,6,5,7,10,,102,32,70,,1,2,0,5,0,0,3,56,63,
1521,Scott Graham,7,95,98,12,3,9,2,7,38,,0,0,0,,2,5,0,2,0,0,20,75,112,
1522,Simon Johansen,10,202,250,23,14,9,1,7,120,88.89,0,0,0,54.4,14,14,0,3,0,0,174,28,185,
1523,Colum Bergeron,4,69,44,6,2,4,4,7,21,,478,134,344,,3,1,0,2,0,0,4,65,73,
1524,Zachary Eskin,20,212,164,6,0,6,6,7,19,,0,0,0,22.56,3,2,0,3,0,1,33,179,206,
1525,Johnny Hock,16,131,0,8,5,3,6,7,107,94.69,0,0,0,,0,6,0,1,0,2,36,95,0,
1526,Darin Graves,13,138,91,8,4,4,4,7,36,,0,0,0,,2,4,0,1,0,0,16,122,101,
1527,Jordan Robarge,19,262,214,14,11,3,7,7,169,93.37,0,0,0,37.38,9,12,0,2,0,13,51,211,276,
1528,David Angeletti,10,125,96,9,1,8,2,7,14,,0,0,0,,2,1,0,3,0,0,50,75,109,
1529,Eric Lewis,8,28,0,11,3,8,7,7,80,,0,0,0,,0,10,0,1,0,0,12,16,0,
1530,Xavier Maxstadt,52,950,870,92,74,18,28,7,767,85.41,0,0,0,39.77,58,106,0,7,0,349,333,617,852,Handler
1531,Matt Stegemann,5,58,77,7,2,5,2,7,31,,0,0,0,,1,2,0,0,0,0,27,31,83,
1532,Matt Tomasko,7,18,0,6,2,4,3,7,13,,0,0,0,,0,2,0,0,0,0,11,7,0,
1533,Casey Ikeda,12,244,238,9,5,4,4,7,230,96.23,0,0,0,34.87,10,6,1,0,0,0,83,161,239,
1534,Cullen Coyne,12,170,119,7,0,7,7,7,45,,0,0,0,25.21,5,3,0,4,0,0,22,148,144,
1535,Kyle Conniff,11,108,82,9,6,3,2,7,38,,35,32,3,,2,2,0,2,0,2,31,77,103,Defender
1536,Clement Yip,17,253,222,15,2,13,3,7,51,,0,0,0,44.14,4,8,0,3,0,0,109,144,202,
1537,Elliot Trotter,9,131,121,8,2,6,3,7,72,,0,0,0,42.15,7,2,0,2,0,1,45,86,118,
1538,Yusuf Abdullah,10,157,107,5,3,2,4,7,32,,0,0,0,39.25,2,1,0,1,0,0,32,125,127,Defender
1539,Kevin Chu,9,39,0,12,5,7,3,7,42,,0,0,0,,0,6,0,2,0,0,17,22,0,
1540,Bret Coffey,7,82,79,4,1,3,3,7,18,,0,0,0,,1,0,0,0,0,0,17,65,77,
1541,Kevin Christian,19,259,206,17,12,5,8,7,165,88.71,0,0,0,42.23,13,16,0,2,0,15,5,254,218,Handler
1542,Ted Schewe,13,145,148,18,5,13,1,7,65,,1244,478,766,46.62,11,9,0,3,0,0,77,68,184,
1543,Ryan Smith,9,118,82,9,5,4,1,7,62,,0,0,0,,4,3,0,0,0,13,28,90,113,
1544,Stefan Samu,6,71,51,4,1,3,3,7,16,,384,139,245,,2,0,0,0,0,0,1,70,81,Defender
1545,Ryan Hahn,9,201,282,27,17,10,1,7,294,93.04,0,0,0,32.62,14,16,1,5,0,1,186,15,177,
1546,Snyder,3,33,27,6,4,2,2,7,26,,0,0,0,,3,0,1,1,0,0,0,33,30,
1547,Bailey Wu,11,106,53,3,3,0,5,7,23,,0,0,0,,0,0,0,1,0,0,1,105,83,
1548,David Hammer,13,161,125,11,6,5,4,7,50,,0,0,0,34.4,5,5,0,3,0,2,9,152,148,
1549,Scott Sottosanti,12,387,501,77,48,29,13,7,452,84.17,0,0,0,34.73,33,79,0,4,0,4,321,66,372,
1550,Trevor Harper,10,260,349,46,30,16,15,7,414,87.9,0,0,0,29.51,27,45,1,9,0,19,216,44,229,
1551,Braden Eberhard,6,101,81,9,3,6,2,7,63,,606,427,179,,9,2,0,2,0,0,48,53,100,
1552,Scott Schriner,12,344,490,50,33,17,10,7,622,91.34,0,0,0,35.1,28,49,2,4,0,0,298,46,368,
1553,Doug Roman,7,85,58,6,2,4,5,7,13,,0,0,0,,2,4,0,0,0,0,16,69,73,
1554,Jack Kingsley,11,238,251,20,8,12,10,7,84,,0,0,0,19.92,8,12,0,11,0,60,105,133,179,
1555,Ryan Welch,8,86,50,8,2,6,1,7,11,,0,0,0,,2,2,0,0,0,0,13,73,63,Defender
1556,John Walden,13,199,160,16,8,8,2,7,72,,0,0,0,41.25,10,10,0,1,0,0,28,171,179,
1557,Jeffrey Silverman,7,76,72,6,4,2,3,7,47,,0,0,0,,5,2,0,0,0,0,7,69,84,
1558,Joseph Cubitt,24,590,750,93,70,23,13,7,1058,90.66,4870,3379,1491,37.33,45,90,1,9,0,23,521,69,714,
1559,Marc Soldini,14,184,220,13,2,11,6,6,30,,0,0,0,25.45,4,11,0,2,0,3,110,74,169,
1560,Brandon Dial,16,161,106,7,4,3,6,6,29,,70,-20,90,32.08,3,5,0,2,0,3,21,140,144,
1561,Ivan Tran,7,108,44,5,2,3,1,6,16,,248,56,192,,1,0,0,0,0,2,1,107,102,
1562,Matt Chambers,6,76,61,6,3,3,4,6,65,,441,247,194,,5,3,0,1,0,0,12,64,95,
1563,Thomas Lalonde-Landry,7,81,37,5,3,2,1,6,20,,176,127,49,,2,0,0,0,0,0,1,80,86,
1564,Hayden Wachob,13,220,218,26,12,14,3,6,219,90.5,32,-15,47,48.62,13,20,0,3,0,15,141,79,212,
1565,Thomas Duplaix,9,163,93,9,5,4,4,6,59,,608,441,167,,4,7,0,0,0,6,9,154,161,
1566,Tianchuan Yen,5,78,47,8,1,7,0,6,22,,0,0,0,,3,1,0,1,0,0,3,75,58,
1567,Sean Donnellan,32,404,232,41,20,21,15,6,503,92.29,0,0,0,31.03,7,40,0,10,0,5,277,127,168,
1568,Connor Anderson,5,74,63,8,2,6,3,6,26,,0,0,0,,2,5,0,0,0,6,28,46,56,Defender
1569,Luke Rehfuss,5,65,37,5,1,4,2,6,13,,334,-3,337,,1,1,0,0,0,0,0,65,76,
1570,Wesley Chen,7,127,134,14,4,10,3,6,77,,0,0,0,26.12,3,5,0,6,0,2,75,52,135,Cutter
1571,Max Shepard,10,105,106,6,1,5,8,6,44,,0,0,0,39.62,4,4,0,4,0,0,8,97,113,
1572,Zach Barnhart,19,267,261,19,8,11,8,6,230,89.84,0,0,0,26.82,6,18,0,3,0,14,137,130,231,
1573,Nick Phillips,12,134,70,6,2,4,1,6,8,,240,28,212,,1,1,0,0,0,0,3,131,157,
1574,Jesse Dahms,12,141,99,7,0,7,3,6,9,,0,0,0,,1,3,0,1,0,1,38,103,104,
1575,Ryan Schanz,6,76,54,6,1,5,3,6,22,,0,0,0,,3,2,0,1,0,0,18,58,68,
1576,Valley Renshaw,4,64,59,9,4,5,2,6,17,,0,0,0,,2,4,0,1,0,0,32,32,54,
1577,Peter van de Burgt,6,60,45,2,0,2,5,6,10,,0,0,0,,1,1,0,0,0,1,6,54,54,
1578,David Picone,13,290,360,33,22,11,11,6,324,88.52,0,0,0,33.61,21,33,0,5,0,34,160,130,298,
1579,Ryan Sutter,2,37,45,7,5,2,0,6,41,,0,0,0,,1,1,0,0,0,0,31,6,24,
1580,Burke Nash,11,110,0,9,0,9,5,6,39,,0,0,0,,0,3,0,5,0,0,32,78,0,
1581,Mike Kobyra,13,172,153,13,6,7,7,6,45,,0,0,0,35.29,6,13,0,1,0,14,27,145,161,
1582,Simon Ayotte,11,170,195,10,5,5,8,6,61,,0,0,0,35.38,6,6,0,6,0,0,73,97,165,
1583,Ed Yanosik,8,111,73,5,2,3,1,6,36,,0,0,0,,5,0,0,0,0,0,10,101,88,
1584,Phil Chang,19,228,122,7,6,1,5,6,54,,188,151,37,35.25,2,5,0,1,0,0,23,205,201,
1585,Alex Hamilton,11,138,67,3,0,3,6,6,11,,115,-13,128,,2,2,0,1,0,0,5,133,132,
1586,Lucas Dillow,10,140,92,11,5,6,2,6,36,,0,0,0,,3,6,0,1,0,2,7,133,120,
1587,Shane Froebe,7,156,166,12,7,5,5,6,110,89.43,0,0,0,31.33,11,9,0,2,0,0,85,71,114,
1588,Adam Russell,31,480,398,35,27,8,17,6,358,88.4,0,0,0,31.91,21,42,0,4,0,3,137,343,447,
1589,David Boyea,7,70,37,6,5,1,0,6,11,,0,0,0,,0,0,0,0,0,1,8,62,44,
1590,Dave Ritchie,15,145,90,9,1,8,2,6,36,,0,0,0,,5,4,0,1,0,0,17,128,129,
1591,Tony Cain,7,127,92,7,3,4,3,6,48,,0,0,0,,5,3,0,1,0,0,30,97,102,
1592,Gustavo Castano,27,471,572,46,43,3,10,6,623,90.68,0,0,0,43.18,42,46,1,4,0,4,352,119,441,
1593,Dylan Wolff,7,16,0,7,6,1,5,6,42,,0,0,0,,0,6,0,0,0,0,7,9,0,
1594,Vikram Sethuraman,7,99,54,5,4,1,2,6,16,,0,0,0,,1,1,0,0,0,0,7,92,95,
1595,Elliot Mawby,3,41,29,2,1,1,4,6,3,,0,0,0,,0,0,0,0,0,0,2,39,39,
1596,Tom Allen,14,307,430,40,27,13,8,6,493,90.29,0,0,0,33.95,20,40,0,2,0,5,258,49,350,
1597,Colin Kochenash,7,71,48,6,2,4,1,6,13,,0,0,0,,2,1,0,0,0,0,19,52,51,
1598,Luc Comire,17,356,454,30,20,10,2,6,526,95.12,2405,2340,65,51.76,27,22,2,4,0,0,329,27,383,
1599,Mickey Thompson,14,128,0,10,5,5,5,6,66,,0,0,0,,0,9,0,0,0,0,3,125,0,
1600,Bryce Lozinski,10,110,73,6,1,5,2,6,24,,223,80,143,,4,1,0,1,0,0,7,103,120,Cutter
1601,Luke DiOrio,9,28,0,12,4,8,0,6,54,,0,0,0,,0,6,0,0,0,0,14,14,0,
1602,Wayne Lu,8,93,63,6,2,4,5,6,18,,93,12,81,,1,3,0,2,0,1,10,83,106,Hybrid
1603,Charles Harrity,29,464,386,33,19,14,8,6,306,89.47,0,0,0,33.42,11,28,0,7,0,20,291,173,308,
1604,Andrew Gardner,8,71,39,3,0,3,4,6,14,,0,0,0,,1,1,0,0,0,0,1,70,49,
1605,Max Kesselring,8,129,171,14,4,10,0,6,63,,0,0,0,32.16,3,4,0,4,0,0,113,16,110,
1606,Sam Creed,4,69,74,8,6,2,1,6,70,,0,0,0,,5,2,0,1,0,2,43,26,59,
1607,Jake Worthington,8,98,62,3,0,3,4,6,25,,546,106,440,,3,1,0,0,1,0,3,95,125,
1608,Colin Copler,8,76,50,3,1,2,4,6,14,,0,0,0,,0,1,0,0,0,0,6,70,57,
1609,Justin Latz,8,137,205,16,9,7,8,6,100,84.03,0,0,0,35.12,9,16,0,2,0,0,126,11,153,
1610,Jake Butrica,10,132,98,13,8,5,4,6,107,89.92,1004,668,336,,3,11,0,0,0,5,38,94,166,Handler
1611,David Zhou,6,82,56,7,3,4,1,6,21,,389,227,162,,1,1,0,1,0,0,4,78,95,Hybrid
1612,Sajed Dosenbach,10,123,0,5,2,3,6,6,32,,0,0,0,,0,4,0,1,0,0,15,108,0,
1613,Eric Lu,13,167,158,6,5,1,6,6,54,,0,0,0,24.68,4,5,0,1,0,1,59,108,171,
1614,Trevor Lynch,14,199,99,8,1,7,4,6,50,,742,360,382,,6,3,0,3,0,19,1,198,217,Cutter
1615,Carter Hollo,21,301,340,23,8,15,5,6,100,84.75,0,0,0,40.0,11,17,1,5,0,0,188,113,293,
1616,Pete Overright,8,115,67,2,1,1,6,6,4,,0,0,0,,0,2,0,0,0,0,11,104,93,
1617,Kevin Herrera,4,74,95,8,4,4,0,6,91,,984,719,265,,8,1,0,1,0,0,74,0,82,
1618,Tevor Balfour,8,114,67,4,2,2,6,6,28,,452,42,410,,2,4,0,0,0,15,22,92,113,
1619,Brenton Hard,15,138,26,13,2,11,10,6,58,,0,0,0,,1,11,0,6,0,74,42,96,26,
1620,Sullivan Wilkes,12,188,140,6,4,2,6,6,27,,0,0,0,26.43,3,4,0,2,0,0,42,146,161,
1621,Karl Staber,7,137,86,8,4,4,3,6,54,,0,0,0,,6,5,0,0,0,0,23,114,112,
1622,Josh Markette,2,36,41,8,4,4,0,6,43,,465,229,236,,1,1,0,1,0,0,36,0,36,
1623,Zach Floyd,9,101,68,5,2,3,1,6,34,,0,0,0,,4,0,0,0,0,1,18,83,87,
1624,Bryan Kuo,11,104,78,4,2,2,4,6,27,,320,80,240,,2,2,0,0,0,0,13,91,117,
1625,George Voellinger,13,315,339,20,9,11,9,6,207,88.46,0,0,0,23.3,15,19,0,4,0,56,157,158,239,
1626,Matt Goodkey,14,225,179,10,7,3,6,6,57,,0,0,0,44.13,2,10,1,0,0,7,44,181,186,
1627,Estéban Ceballos,24,363,298,15,9,6,12,6,92,84.4,0,0,0,32.89,11,14,0,7,0,258,62,301,325,
1628,Teddy Browar-Jarus,14,138,0,39,30,9,9,6,207,86.25,0,0,0,,0,33,0,9,0,0,67,71,0,
1629,Samuel Brennan,9,35,0,12,3,9,4,6,45,,0,0,0,,0,7,0,3,0,0,15,20,0,
1630,Dan Reed,11,99,82,4,1,3,5,6,19,,0,0,0,,0,1,1,2,0,0,11,88,93,
1631,Francisco Hezera,6,117,96,4,0,4,7,6,20,,0,0,0,,4,3,0,2,0,0,18,99,94,
1632,Curtis Campbell,6,67,32,2,0,2,4,6,8,,223,61,162,,1,0,1,0,0,2,0,67,69,
1633,Ben Johnson,2,4,0,2,0,2,5,6,7,,0,0,0,,0,1,0,0,0,0,2,2,0,
1634,Cooper Brotman,17,295,255,17,11,6,8,6,111,84.73,0,0,0,34.9,12,14,0,5,0,0,33,262,258,
1635,Zachary Cotter,3,29,19,1,0,1,4,5,3,,0,0,0,,0,0,0,0,0,0,3,26,23,
1636,Cole Moore,8,117,95,13,12,1,1,5,48,,1138,481,657,,3,8,0,1,0,0,58,59,124,
1637,Ryan Turner,3,49,51,7,3,4,0,5,20,,280,49,231,,1,1,0,1,0,0,41,8,51,
1638,Jack Wooldridge,10,78,70,2,0,2,4,5,10,,0,0,0,,0,1,0,0,0,1,9,69,70,Defender
1639,Robert Yeagle,6,61,37,4,2,2,3,5,17,,0,0,0,,1,1,0,1,0,0,4,57,49,
1640,Mutahir Ahmad,5,91,115,11,4,7,0,5,121,93.08,0,0,0,46.96,10,5,0,1,0,0,73,18,91,
1641,Ilya Yudkovich,11,216,99,13,10,3,3,5,122,90.37,990,831,159,,11,8,0,3,0,22,9,207,208,
1642,Ian Meyer,10,154,101,8,5,3,5,5,62,,0,0,0,35.64,4,8,0,0,0,0,14,140,123,
1643,Jacob Smith,4,51,38,6,1,5,2,5,14,,0,0,0,,2,1,0,2,0,0,2,49,35,
1644,Brian T,6,109,144,9,6,3,2,5,116,93.55,0,0,0,40.28,3,6,0,0,0,0,85,24,118,
1645,Brandon Van Deusen,9,156,197,23,16,7,2,5,174,90.16,2085,1122,963,50.25,18,18,0,2,0,1,146,10,177,Hybrid
1646,Kirk Nylen,1,21,18,5,2,3,0,5,11,,0,0,0,,1,0,0,0,0,0,9,12,20,
1647,Cameron Snook,13,155,126,9,2,7,2,5,21,,0,0,0,33.33,2,5,0,1,0,0,57,98,129,
1648,John Geraghty,7,87,87,6,1,5,2,5,16,,0,0,0,,1,2,0,1,0,0,8,79,77,
1649,Alan Scarth,9,140,98,11,9,2,4,5,105,92.11,0,0,0,,3,9,0,1,0,0,31,109,129,Hybrid
1650,James Lewis,5,67,37,2,0,2,4,5,8,,141,21,120,,0,1,0,0,0,0,7,60,64,
1651,Justin Moore,15,230,245,17,3,14,3,5,89,85.58,0,0,0,35.92,10,13,1,2,0,1,150,80,206,
1652,Jonah Kurman-Faber,11,171,93,10,6,4,3,5,95,91.35,1026,687,339,,7,8,0,0,0,100,21,150,171,
1653,Matt Hurray,6,33,0,4,2,2,3,5,10,,0,0,0,,0,2,0,0,0,0,1,32,0,
1654,Colin Sunde,2,29,37,6,3,3,1,5,14,,321,123,198,,1,1,0,1,0,1,25,4,33,
1655,Isaac Smith,13,156,131,11,7,4,1,5,53,,0,0,0,37.4,5,4,0,3,0,1,21,135,135,
1656,Ashton Robinson,6,62,0,4,0,4,4,5,6,,0,0,0,,0,1,0,2,0,0,32,30,0,
1657,Chris Liess,11,136,108,8,3,5,3,5,23,,0,0,0,27.78,4,1,0,5,0,0,20,116,123,
1658,Brawley Adams,9,139,106,12,7,5,5,5,71,,0,0,0,32.08,3,10,0,2,0,41,18,121,136,
1659,Adam Goldberg,4,54,52,4,3,1,4,5,9,,0,0,0,,1,3,0,0,0,0,17,37,48,
1660,Louis-Pierre Lauzon,5,65,62,3,1,2,2,5,9,,0,0,0,,3,0,0,0,0,0,29,36,52,
1661,Ryan Flamberg,3,41,35,2,1,1,5,5,7,,0,0,0,,0,1,0,1,0,0,11,30,35,
1662,Ryans Simmons,5,56,43,7,3,4,0,5,12,,0,0,0,,2,2,0,0,0,0,3,53,47,
1663,Erik Lindberg,5,86,142,17,12,5,4,5,82,,0,0,0,29.58,2,11,0,5,0,5,56,30,108,
1664,Jake Cormier,6,12,0,4,0,4,3,5,18,,0,0,0,,0,2,0,0,0,0,6,6,0,
1665,Nick Roberts,2,44,45,7,0,7,0,5,15,,0,0,0,,3,1,0,1,0,0,19,25,42,
1666,Alex Grande,10,130,84,7,4,3,3,5,33,,0,0,0,,4,1,0,4,0,5,28,102,97,
1667,Danny Khoe,17,251,253,16,8,8,9,5,129,86.58,171,68,103,27.67,7,19,0,1,0,0,81,170,256,
1668,Clay Collins,4,64,70,7,3,4,1,5,31,,0,0,0,,3,1,0,2,0,0,46,18,51,
1669,Robert Goode,8,128,157,12,3,9,2,5,43,,0,0,0,45.22,4,7,0,2,0,1,71,57,120,
1670,Zach Jackson,7,71,42,6,2,4,2,5,6,,0,0,0,,0,2,0,1,0,0,13,58,47,
1671,Danny Shonk,7,85,76,3,0,3,5,5,30,,0,0,0,,2,3,0,0,0,4,15,70,82,
1672,Cameron Baker,9,103,61,7,3,4,2,5,9,,40,20,20,,1,4,0,0,0,15,13,90,78,Hybrid
1673,Micah Jo,3,59,80,10,3,7,1,5,100,95.24,0,0,0,,7,5,1,1,0,0,54,5,59,
1674,Hamilton Wasnick,5,43,33,4,0,4,4,5,6,,0,0,0,,1,2,0,1,0,0,10,33,43,
1675,Kendrick Pennington,9,101,86,9,3,6,3,5,24,,0,0,0,,5,6,0,1,0,12,22,79,89,
1676,Reggie Sung,16,165,95,9,3,6,1,5,25,,512,120,392,,2,4,0,1,0,1,0,165,158,Defender
1677,Billy Mainwaring,17,189,194,9,2,7,6,5,36,,0,0,0,20.62,6,7,0,3,0,64,57,132,156,Cutter
1678,Clay Schelitzche,13,140,0,4,0,4,3,5,20,,0,0,0,,0,0,0,2,0,0,26,114,0,
1679,John Ramerman,5,8,0,3,0,3,3,5,9,,0,0,0,,0,1,0,0,0,0,5,3,0,
1680,David Ward,7,17,0,6,3,3,5,5,43,,0,0,0,,0,5,0,1,0,0,7,10,0,
1681,Sam Lehman,4,77,86,7,1,6,0,5,36,,0,0,0,,3,2,0,0,0,0,52,25,65,
1682,Moussa Dia,1,24,19,3,0,3,3,5,4,,170,6,164,,0,1,0,0,0,0,0,24,25,
1683,Zack Purdy,4,87,65,5,1,4,2,5,7,,0,0,0,,0,1,1,1,0,0,21,66,55,
1684,Justin Ilowite,7,127,124,15,4,11,6,5,60,,0,0,0,33.87,5,16,0,0,0,17,54,73,115,
1685,Jackson Potts,6,75,50,6,3,3,0,5,22,,433,222,211,,3,1,0,0,0,0,6,69,84,
1686,Zakarie Massi,4,46,23,6,5,1,1,5,8,,0,0,0,,0,0,0,2,0,0,7,39,34,
1687,Patrick Keenan,5,58,47,4,3,1,4,5,18,,0,0,0,,4,2,0,1,0,0,4,54,48,
1688,Colin Grant,9,113,85,7,3,4,3,5,33,,606,157,449,,7,1,0,4,0,1,16,97,142,
1689,Jonathan Holloway,9,100,94,10,7,3,1,5,24,,0,0,0,,3,5,0,1,0,6,35,65,112,
1690,Kainoa Chun Moy,9,90,42,7,5,2,2,5,23,,706,218,488,,3,4,0,0,0,0,0,90,100,Handler
1691,Jimmy Zuraw,8,128,138,12,8,4,4,5,118,92.91,0,0,0,31.16,6,9,0,2,0,37,51,77,153,
1692,Connor Lukas,12,220,287,24,11,13,7,5,148,89.16,0,0,0,28.92,5,17,1,9,0,4,159,61,229,
1693,Josh Botti,5,10,0,3,2,1,4,5,15,,0,0,0,,0,2,0,0,0,0,5,5,0,
1694,Alex Heath,6,70,47,5,5,0,2,5,39,,465,340,125,,2,2,0,0,0,0,1,69,86,
1695,Frank Barich,6,102,105,9,5,4,2,5,48,,0,0,0,44.76,3,6,0,0,0,1,53,49,91,
1696,Zach Branson,8,110,129,10,8,2,2,5,109,93.16,0,0,0,38.76,6,4,0,3,0,0,76,34,102,
1697,Andrew Gruninger,17,177,123,10,4,6,3,5,36,,0,0,0,35.77,6,6,0,2,0,0,23,154,144,
1698,Jason Lam,18,236,185,15,9,6,8,5,158,90.29,521,382,139,45.95,12,15,0,3,0,1,39,197,277,
1699,Ford Heacock,3,44,45,6,1,5,0,5,23,,0,0,0,,1,1,1,0,0,0,31,13,38,
1700,Francis Martel,5,69,49,3,1,2,3,5,21,,0,0,0,,2,1,0,0,0,0,13,56,61,
1701,Evan Magsig,8,105,68,6,2,4,3,5,46,,393,51,342,,2,4,0,0,0,0,2,103,131,
1702,Cedric Aubut-Boucher,12,110,90,7,1,6,2,5,18,,0,0,0,,2,2,0,2,0,0,14,96,106,
1703,Alex Cameron,4,63,34,5,1,4,2,5,20,,337,258,79,,2,2,0,0,0,0,6,57,57,
1704,Joshua Layton,12,127,123,9,5,4,4,5,43,,0,0,0,35.77,1,4,0,4,0,0,50,77,137,
1705,Pete Proulx,9,105,67,3,0,3,3,5,8,,0,0,0,,0,0,0,1,0,0,3,102,81,
1706,Chris Brenenborg,24,473,509,40,36,4,7,5,553,92.63,0,0,0,52.06,57,39,1,3,0,0,251,222,408,
1707,Ross Osborn,9,161,169,9,4,5,7,5,38,,0,0,0,21.89,3,5,0,6,0,3,53,108,162,
1708,Jeremy Knopf,8,106,82,5,2,3,5,5,57,,163,132,31,,6,3,0,2,0,0,28,78,98,
1709,Sean Treacy,5,59,73,7,1,6,2,5,22,,189,82,107,,3,2,0,2,0,1,21,38,69,
1710,Kevin Anthony,15,236,301,20,14,6,5,5,197,90.78,2058,1316,742,38.21,19,19,1,1,0,0,215,21,283,
1711,Andy Yu,8,120,151,12,10,2,2,4,164,93.71,0,0,0,42.38,10,9,0,1,0,1,102,18,111,Cutter
1712,Nigel Daniels,10,79,0,4,0,4,6,4,57,,0,0,0,,0,4,0,2,0,0,68,11,0,
1713,Stephen Schlatter,7,88,100,6,3,3,3,4,21,,0,0,0,21.0,1,4,0,1,0,0,53,35,92,
1714,Matt Hanna,9,141,126,11,3,8,1,4,70,,1300,183,1117,45.24,6,6,0,2,0,0,81,60,174,Cutter
1715,Will Frolich,7,96,59,2,1,1,4,4,25,,223,161,62,,4,1,0,1,0,0,2,94,101,
1716,Matt Anderson,6,17,10,2,0,2,2,4,5,,0,0,0,,0,0,0,0,0,0,7,10,11,
1717,Daniel Montoya,6,70,40,3,0,3,1,4,9,,0,0,0,,0,0,0,0,0,0,5,65,57,
1718,Brian Jager,10,217,295,13,8,5,3,4,257,94.49,0,0,0,35.59,8,11,0,1,0,1,201,16,217,
1719,Carleton Anker,2,36,24,2,0,2,2,4,6,,0,0,0,,0,0,0,0,0,4,2,34,24,
1720,Mitchell Dozzi-Daigle,10,148,95,5,3,2,3,4,24,,0,0,0,,3,4,0,0,0,13,24,124,108,
1721,Noriaki To,8,70,35,3,2,1,2,4,18,,146,77,69,,2,1,0,0,0,0,0,70,64,
1722,Dan Benvenuti,6,91,64,4,1,3,1,4,15,,462,82,380,,5,0,0,1,0,0,25,66,88,
1723,Greg Somerville,7,63,0,8,5,3,3,4,35,,0,0,0,,0,5,0,2,0,6,3,60,0,
1724,Martin Newman,5,89,62,4,0,4,5,4,32,,0,0,0,,3,5,0,0,0,3,18,71,74,
1725,Pat Kelsy,10,39,0,13,4,9,0,4,55,,0,0,0,,0,9,0,0,0,0,19,20,0,
1726,Marc Rovner,4,61,45,3,1,2,3,4,15,,190,41,149,,3,1,0,1,0,29,1,60,69,Handler
1727,Tyler Mitchuson,9,139,85,2,0,2,5,4,10,,164,4,160,,0,2,0,1,0,39,25,114,142,
1728,Josh Stevens-Stein,8,88,102,5,1,4,6,4,30,,0,0,0,38.24,2,3,0,4,0,16,19,69,98,
1729,Andrew Haviland,8,147,127,15,6,9,4,4,62,,0,0,0,26.77,2,14,0,1,0,51,50,97,129,
1730,Tyler McKean,8,36,0,3,1,2,6,4,15,,0,0,0,,0,3,0,2,0,0,4,32,0,
1731,Tyler Sadler,23,391,341,29,26,3,13,4,208,84.55,0,0,0,31.67,6,32,2,6,0,3,79,312,384,
1732,Max Hunter,11,146,88,8,3,5,2,4,36,,0,0,0,,3,3,0,3,0,50,20,126,117,
1733,Jaime Perez,26,335,253,13,6,7,5,4,107,88.43,441,318,123,41.11,6,12,0,2,0,151,98,237,310,
1734,Colton Steiner,26,316,216,12,3,9,5,4,79,,0,0,0,39.35,10,10,0,3,0,2,21,295,264,
1735,Jonathan Hatcher,9,64,0,5,3,2,2,4,25,,0,0,0,,0,1,0,2,0,0,7,57,0,
1736,Shane Hohenstein,3,42,42,2,0,2,3,4,6,,0,0,0,,1,1,0,0,0,0,11,31,45,
1737,Charles Cannon,10,148,125,9,4,5,3,4,85,,0,0,0,39.2,4,6,0,2,0,7,49,99,125,
1738,Ben Cheer,11,235,237,17,4,13,10,4,87,82.08,0,0,0,26.16,8,19,0,4,0,14,120,115,274,
1739,Alex Vickroy,7,123,160,17,14,3,0,4,91,87.5,0,0,0,45.63,8,9,0,4,0,0,102,21,125,
1740,Derek Mourad,3,79,57,1,1,0,3,4,34,,0,0,0,,3,0,0,0,0,62,6,73,77,
1741,Blake Krapfl,3,60,49,4,3,1,1,4,16,,298,157,141,,3,1,0,0,0,0,1,59,61,
1742,Sam Trachtman,14,209,208,13,7,6,4,4,195,95.12,0,0,0,45.67,12,9,0,4,0,0,92,117,206,
1743,Nathan Bussberg,3,42,26,3,1,2,1,4,11,,0,0,0,,0,0,0,0,0,0,0,42,32,
1744,Alexander Max,6,97,89,8,5,3,1,4,34,,0,0,0,,6,3,0,2,0,0,41,56,76,
1745,Paul Weeks,11,207,290,27,16,11,7,4,268,88.16,0,0,0,41.03,22,28,0,2,1,0,185,22,223,
1746,Tron Bass,9,40,25,2,0,2,3,4,5,,0,0,0,,0,1,0,0,0,0,6,34,34,
1747,Paul Butterfoss,5,46,0,4,4,0,6,4,38,,0,0,0,,0,6,0,0,0,5,9,37,0,
1748,Mike Tillotson,6,78,69,3,0,3,2,4,8,,0,0,0,,2,0,0,1,0,0,39,39,66,
1749,Tyler Bloodworth,6,40,8,2,0,2,3,4,5,,0,0,0,,0,1,0,0,0,1,14,26,8,
1750,Sebbi Di Francesco,6,66,53,4,2,2,3,4,41,,0,0,0,,5,3,0,0,0,2,5,61,60,
1751,Chris Liu,6,67,47,4,1,3,1,4,22,,0,0,0,,3,1,0,0,0,0,16,51,56,
1752,Joshua Yuan,9,106,72,7,0,7,1,4,15,,0,0,0,,1,2,0,2,0,0,13,93,80,
1753,Glenn Wysen,7,116,104,6,3,3,1,4,126,95.45,85,69,16,47.12,5,3,0,0,0,4,51,65,108,
1754,Cody Coates,5,54,34,3,0,3,3,4,6,,211,-7,218,,1,0,0,2,0,0,11,43,50,
1755,Dave Kelly,13,266,363,28,14,14,8,4,342,92.43,0,0,0,34.99,15,26,0,6,0,3,232,34,284,
1756,Danny Desbiens-Alary,7,93,87,4,2,2,3,4,29,,0,0,0,,3,3,0,0,0,0,32,61,85,
1757,Leander Ramirez,7,83,82,4,1,3,3,4,33,,392,109,283,,4,3,0,0,0,1,32,51,96,Cutter
1758,Matt LaBar,8,54,19,2,2,0,2,4,8,,138,84,54,,2,0,0,0,0,1,0,54,52,Defender
1759,Brian Shinners,2,14,8,1,0,1,3,4,6,,0,0,0,,0,0,0,0,0,0,1,13,12,
1760,Rhys Toogood,6,102,116,8,5,3,2,4,74,,644,528,116,56.03,4,4,0,2,0,0,81,21,115,
1761,Kevin Reichert,8,155,0,20,16,4,8,4,390,94.43,0,0,0,,0,23,0,1,0,0,115,40,0,
1762,Nikhal Bhakta,1,22,26,3,0,3,2,4,4,,0,0,0,,0,0,1,1,0,0,12,10,24,
1763,Brian Pate,7,14,0,5,3,2,7,4,72,,0,0,0,,0,8,0,0,0,0,8,6,0,
1764,Ryan Slaughter,24,346,426,18,3,15,4,4,364,95.54,0,0,0,44.37,9,12,0,6,0,0,285,61,339,
1765,Chris Farina,26,400,319,17,7,10,9,4,122,84.72,0,0,0,39.81,15,19,0,3,0,2,39,361,349,
1766,Jeremy Sellers,5,79,62,4,1,3,2,4,20,,0,0,0,,1,0,0,2,0,0,29,50,39,
1767,Connor Fortin,19,192,159,10,3,7,3,4,60,,0,0,0,29.56,7,8,0,1,0,0,113,79,128,
1768,Tony Venneri,3,56,35,1,0,1,5,4,25,,270,172,98,,5,2,0,0,0,2,0,56,62,Handler
1769,Casey Thornton,2,42,49,6,3,3,0,4,63,,655,402,253,,5,2,0,0,0,0,42,0,41,Hybrid
1770,Eric Hillis,7,112,106,10,3,7,3,4,74,,0,0,0,41.51,8,7,0,2,0,54,22,90,80,
1771,Jordan Rhyne,11,60,34,10,8,2,5,4,79,,0,0,0,,1,9,0,2,0,3,25,35,37,
1772,Ryan Saffa,9,61,35,0,0,0,5,4,12,,0,0,0,,2,0,0,1,0,0,10,51,44,Cutter
1773,Kyle Johnson,4,53,43,1,0,1,3,4,7,,0,0,0,,2,0,0,0,1,0,6,47,47,
1774,Tyler Haskell,7,71,53,4,1,3,2,4,11,,0,0,0,,2,2,0,0,0,0,6,65,60,
1775,Gabe Taylor,12,138,64,6,3,3,2,4,43,,0,0,0,,2,4,0,0,0,0,7,131,108,
1776,Mauricio Martinez,9,96,71,5,1,4,2,4,54,,0,0,0,,4,3,0,0,0,0,1,95,99,
1777,Andrew Manganelli,22,341,109,31,16,15,22,4,218,84.82,0,0,0,44.04,5,39,0,10,0,6,232,109,74,
1778,Ethan Li,1,17,12,3,1,2,1,4,8,,124,47,77,,1,0,0,0,0,0,0,17,19,
1779,Alexi Zalk,2,26,32,3,2,1,1,4,9,,0,0,0,,1,0,0,0,0,0,24,2,20,Cutter
1780,Will Sloane,12,262,387,34,29,5,3,4,239,87.87,0,0,0,34.88,15,28,0,5,0,0,242,20,276,
1781,Marquis Cofer,10,91,45,4,1,3,3,4,9,,0,0,0,,2,2,0,1,0,0,6,85,73,
1782,Max Williams,10,152,88,6,1,5,4,4,9,,340,37,303,,2,3,0,3,0,0,2,150,178,
1783,Ryan Wallace,10,82,57,2,0,2,4,4,18,,0,0,0,,2,1,0,1,0,0,4,78,71,
1784,Aidan Hall,12,124,74,5,1,4,0,4,24,,0,0,0,,1,0,0,1,0,0,2,122,122,
1785,Nathan Buddemeyer,6,38,0,2,0,2,2,3,3,,0,0,0,,0,0,0,1,0,0,19,19,0,
1786,Steven Garlok,4,53,40,3,2,1,2,3,13,,0,0,0,,1,0,0,2,0,0,3,50,48,
1787,Stan Birdsong,4,42,22,3,1,2,0,3,11,,0,0,0,,2,0,0,0,0,0,10,32,34,
1788,Dennis Bechis,3,56,31,6,2,4,0,3,21,,0,0,0,,1,0,0,3,0,0,7,49,39,
1789,Lars Hanselman,4,53,37,4,0,4,1,3,22,,0,0,0,,4,2,0,0,0,0,12,41,48,
1790,Mark Stumpf,3,31,23,2,0,2,1,3,5,,0,0,0,,0,0,0,0,0,0,0,31,27,
1791,Ben Davies,8,129,166,12,7,5,1,3,159,94.08,0,0,0,48.8,15,9,0,1,0,0,114,15,141,
1792,Greg Esser,8,73,0,4,0,4,4,3,13,,0,0,0,,0,1,0,4,0,0,14,59,0,
1793,Beau Hawkinson,2,20,18,2,0,2,1,3,3,,0,0,0,,1,0,0,0,0,0,1,19,13,Defender
1794,Benjamin Eto,6,60,68,5,2,3,1,3,83,,0,0,0,,3,3,0,0,0,1,46,14,53,
1795,Adam Bostian,10,117,90,6,3,3,3,3,17,,0,0,0,,2,4,0,2,0,0,32,85,86,
1796,Jon Gaynor,5,88,96,8,6,2,8,3,77,,0,0,0,,6,13,0,0,0,0,19,69,98,
1797,Conrad Schloer,4,37,20,3,0,3,1,3,3,,0,0,0,,1,0,0,1,0,0,2,35,31,
1798,Noah Nicol,1,17,12,2,0,2,1,3,9,,113,50,63,,0,0,0,0,0,0,3,14,21,
1799,Ed Melo,9,117,165,10,8,2,2,3,135,93.75,0,0,0,45.45,5,9,0,0,0,0,108,9,136,
1800,Matt Koh,8,77,0,6,2,4,4,3,20,,0,0,0,,0,2,0,5,0,0,20,57,0,
1801,Yuri Kubo,4,9,0,3,0,3,0,3,0,,0,0,0,,0,0,0,0,0,0,4,5,0,
1802,Greg Moore,14,210,225,19,6,13,8,3,64,,0,0,0,34.67,11,17,0,7,0,7,110,100,191,
1803,Mark Zimmerl,7,99,104,10,7,3,0,3,96,92.31,0,0,0,43.27,3,7,0,0,0,51,34,65,101,
1804,Luis Caballero,10,184,216,19,12,7,5,3,235,93.25,0,0,0,38.89,11,15,0,6,0,1,107,77,176,
1805,Kristopher Coley,4,62,83,7,4,3,2,3,74,,0,0,0,,4,6,0,0,0,0,44,18,60,
1806,Eliott Heloir,9,145,81,9,6,3,3,3,90,89.11,1015,808,207,,8,8,0,1,0,13,12,133,132,
1807,Alex Pan,15,226,196,11,4,7,5,3,127,90.71,0,0,0,28.57,11,10,0,3,0,14,55,171,202,
1808,Ian McClellan,12,78,0,30,29,1,5,3,256,90.46,0,0,0,,0,27,0,5,0,0,48,30,0,
1809,Kayhee Fong,3,42,27,4,2,2,0,3,16,,0,0,0,,2,0,0,1,0,0,12,30,34,
1810,Shayna Reppermund,2,32,27,3,0,3,0,3,1,,0,0,0,,0,0,0,0,0,0,4,28,29,
1811,Will Carmichael,3,39,36,3,0,3,1,3,17,,0,0,0,,0,1,0,0,0,6,7,32,40,
1812,Nicky Golini,1,18,29,3,0,3,1,3,31,,0,0,0,,2,0,0,1,0,0,16,2,26,
1813,Matt Young,4,49,53,4,3,1,3,3,16,,0,0,0,,0,2,0,2,0,0,15,34,53,
1814,Steve Calabrese,2,35,0,4,4,0,2,3,34,,0,0,0,,0,3,0,0,0,0,0,35,0,
1815,John Abela,22,245,197,27,13,14,10,3,179,86.47,0,0,0,22.34,2,27,0,7,0,6,91,154,156,
1816,Todd Chamberlain,20,189,65,13,8,5,3,3,87,,0,0,0,,0,10,0,3,1,0,91,98,78,
1817,Pat Barron,4,62,48,3,1,2,1,3,18,,203,61,142,,1,0,0,1,0,0,32,30,60,
1818,Nicholas Betsch,3,29,26,2,1,1,2,3,9,,159,75,84,,0,1,0,0,0,0,0,29,44,
1819,Brandon Thomas,19,267,251,12,5,7,14,3,72,,0,0,0,28.69,4,19,0,4,0,15,46,221,240,
1820,Travion Greene,1,21,12,0,0,0,3,3,1,,0,0,0,,0,0,0,0,0,0,3,18,17,
1821,Troy Roberts,4,63,80,5,3,2,3,3,21,,0,0,0,,2,5,0,0,0,0,56,7,60,
1822,Olivier St-Denis,18,302,331,31,23,8,12,3,185,81.14,0,0,0,35.65,14,34,1,6,0,120,113,189,304,
1823,Ben Broser,6,90,112,4,0,4,2,3,83,,0,0,0,41.07,7,3,0,0,0,1,67,23,88,
1824,Kevin Connolly,10,112,0,12,7,5,1,3,53,,0,0,0,,0,9,0,1,0,2,24,88,0,
1825,Jared Saltsman,13,246,179,4,1,3,8,3,32,,0,0,0,19.55,2,7,0,2,0,2,77,169,184,
1826,Jonathan Costello,1,13,10,2,2,0,1,3,4,,0,0,0,,0,0,0,0,0,0,0,13,12,
1827,Hunter Cutts,1,12,10,3,0,3,0,3,4,,0,0,0,,1,0,0,0,0,0,8,4,9,
1828,Pierre-Yves Lavertu,10,183,252,7,3,4,6,3,117,92.13,0,0,0,44.84,6,9,0,1,0,3,151,32,143,
1829,Kevin Halprin,4,20,13,1,1,0,2,3,2,,0,0,0,,1,0,0,0,0,0,3,17,10,
1830,Victor Taggart,8,127,86,7,1,6,0,3,14,,0,0,0,,3,4,0,0,0,6,29,98,97,
1831,Kyle Morgan,12,136,97,7,2,5,4,3,31,,0,0,0,,1,5,0,3,0,3,11,125,110,
1832,Matt Pasternack,10,40,0,16,3,13,4,3,109,90.08,0,0,0,,0,12,0,5,0,0,21,19,0,
1833,Jason Crowe,7,77,45,3,0,3,0,3,24,,0,0,0,,2,0,0,0,0,0,24,53,73,
1834,Nicholas Woo VonHoogens,4,29,19,0,0,0,3,3,1,,0,0,0,,1,0,0,0,0,2,2,27,25,
1835,Evan Karson,6,71,88,6,4,2,4,3,60,,0,0,0,,4,7,0,0,0,9,32,39,86,Handler
1836,Yiding Hou,12,190,237,14,6,8,14,3,228,90.84,0,0,0,37.97,16,18,1,7,0,9,107,83,197,
1837,Ashton Lewis,5,32,10,1,0,1,2,3,1,,0,0,0,,0,0,0,0,0,0,0,32,18,
1838,Robyn Wiseman,3,47,57,4,3,1,0,3,54,,0,0,0,,3,1,0,0,0,1,39,8,43,
1839,Ian Wallace,4,58,54,4,3,1,2,3,13,,418,135,283,,1,1,0,2,0,22,20,38,62,
1840,Sam Richards,6,11,0,4,0,4,0,3,8,,0,0,0,,0,1,0,0,0,0,5,6,0,
1841,Eike Cramer,9,107,71,3,0,3,1,3,22,,0,0,0,,2,0,0,1,0,0,11,96,101,
1842,Sergio Perdomo,9,125,87,5,3,2,8,3,51,,0,0,0,,6,10,0,0,0,47,17,108,117,
1843,Eric Zarobilia,3,47,37,4,2,2,0,3,13,,0,0,0,,0,1,0,0,0,0,7,40,48,
1844,Patrick Eberle,13,149,98,5,2,3,5,3,30,,0,0,0,,2,7,0,0,0,11,2,147,116,
1845,Christopher Miller,5,59,29,1,0,1,3,3,10,,0,0,0,,0,1,0,0,0,0,7,52,52,
1846,Neal Butler,2,33,27,1,0,1,2,3,2,,0,0,0,,0,0,0,0,0,19,10,23,22,
1847,Kyle Wolf,42,848,875,134,98,36,30,3,1095,87.53,0,0,0,36.34,47,145,0,16,1,21,623,225,697,
1848,Nick Minyen,4,40,20,2,0,2,1,3,4,,0,0,0,,1,0,0,0,0,0,1,39,29,
1849,Jordan Richmond,5,60,48,5,1,4,1,3,16,,0,0,0,,0,2,0,1,0,1,2,58,63,
1850,Nolan Schmalenberger,1,12,7,2,2,0,1,3,6,,69,52,17,,0,0,0,0,0,0,0,12,14,Handler
1851,Josh Poterack,3,32,19,0,0,0,3,3,5,,5,-7,12,,0,0,0,0,0,1,2,30,31,Defender
1852,Thomas Wight,11,134,123,2,0,2,4,3,42,,0,0,0,21.95,3,1,0,2,0,0,46,88,115,
1853,Vince Tranquillo,3,13,10,1,0,1,2,3,2,,0,0,0,,0,0,0,0,0,0,4,9,12,
1854,Olivier Bastien,7,82,50,3,0,3,1,3,7,,150,23,127,,1,1,0,0,0,0,1,81,100,
1855,Alex Donadio,8,124,54,3,2,1,3,3,30,,463,135,328,,4,3,0,0,0,0,0,124,130,
1856,Johnny Frohlichstein,6,86,66,3,3,0,4,3,44,,0,0,0,,3,4,0,0,0,1,10,76,66,
1857,Jeffery Schubert,11,108,67,6,2,4,3,3,16,,70,33,37,,0,4,0,2,0,0,13,95,95,
1858,Matthew Wilson,10,90,69,2,1,1,3,3,20,,0,0,0,,1,0,0,2,1,20,24,66,65,
1859,Corey Mika,11,130,112,5,2,3,3,3,10,,0,0,0,12.5,3,2,0,3,0,0,22,108,120,
1860,Nick Myhre,2,40,51,3,1,2,0,3,39,,0,0,0,,4,0,0,0,0,0,30,10,42,
1861,Chris Zybert,9,35,0,11,4,7,2,3,73,,0,0,0,,0,8,0,2,0,0,14,21,0,
1862,John Haig,8,131,177,13,6,7,0,3,43,,0,0,0,46.89,3,6,0,4,0,0,115,16,115,
1863,Matt LeMaitre,18,242,158,8,5,3,10,3,80,,502,369,133,29.11,4,13,0,2,0,137,30,212,228,
1864,Timmy Setterberg,9,101,0,10,3,7,1,3,40,,0,0,0,,0,2,1,6,0,0,52,49,0,
1865,Ryan Seay,6,64,31,1,0,1,4,3,6,,0,0,0,,1,1,0,1,0,0,5,59,58,
1866,Jake Raatz,1,11,9,0,0,0,3,3,1,,29,12,17,,0,0,0,0,0,0,0,11,14,
1867,Nick Judson,5,18,0,7,1,6,7,3,54,,0,0,0,,0,9,0,2,0,0,8,10,0,
1868,Sean Anderson,9,111,0,9,2,7,4,3,60,,0,0,0,,0,7,0,3,0,0,83,28,0,
1869,Darren Shultz,4,52,38,3,0,3,1,3,4,,0,0,0,,0,1,0,0,0,0,4,48,43,
1870,Jonah Munoz,6,98,68,6,2,4,1,3,49,,718,421,297,,2,3,1,1,0,13,7,91,115,
1871,Jacob Serano,1,15,10,2,1,1,1,2,5,,0,0,0,,2,1,0,0,0,0,1,14,11,
1872,Ian Hahn,5,55,40,2,0,2,1,2,16,,293,99,194,,2,1,0,0,0,0,5,50,72,
1873,Mark Hritz,3,34,34,2,1,1,1,2,15,,0,0,0,,1,0,0,1,0,0,3,31,41,
1874,Graham Grayshaw,1,9,5,1,0,1,1,2,2,,0,0,0,,0,0,0,0,0,0,0,9,5,
1875,Steven Borik,10,78,68,1,1,0,4,2,46,,0,0,0,,3,3,0,0,0,1,7,71,75,
1876,Scott Crabtree,4,5,0,2,1,1,1,2,7,,0,0,0,,0,1,0,0,0,0,2,3,0,
1877,Danny Krug,3,36,21,2,1,1,1,2,3,,0,0,0,,0,0,0,1,0,0,2,34,26,
1878,Tim Barczak,2,15,6,1,1,0,1,2,1,,0,0,0,,0,0,0,0,0,0,2,13,8,
1879,Connor Haley,1,23,13,1,1,0,2,2,6,,0,0,0,,1,0,0,1,0,0,2,21,16,
1880,Alexander Daskalakis,7,58,0,4,0,4,0,2,9,,0,0,0,,0,2,0,0,0,0,15,43,0,
1881,Russ Allen,7,83,53,3,1,2,3,2,28,,0,0,0,,2,4,0,0,0,0,16,67,50,
1882,Pete Dreisbach,3,5,0,2,1,1,0,2,0,,0,0,0,,0,0,0,0,0,0,3,2,0,
1883,Jonathan Kwan,11,103,0,9,3,6,3,2,56,,0,0,0,,0,5,0,5,0,0,64,39,0,
1884,Nikhar Abbas,1,16,10,1,0,1,1,2,0,,0,0,0,,0,0,0,0,0,0,2,14,13,
1885,Tyler Meyer,5,55,28,1,0,1,2,2,13,,0,0,0,,0,1,0,0,0,0,2,53,38,
1886,Alex Guerrero,7,103,51,3,2,1,0,2,18,,207,110,97,,3,1,0,0,0,0,9,94,98,
1887,Stephen Schott,2,24,14,2,2,0,0,2,11,,0,0,0,,2,0,0,0,0,0,0,24,20,
1888,Alex Bargende,4,8,0,3,1,2,3,2,25,,0,0,0,,0,3,0,1,0,0,4,4,0,
1889,Joey Kennedy,9,108,84,7,4,3,1,2,44,,0,0,0,,4,5,0,1,0,0,22,86,107,
1890,Daniel Petronio,2,26,17,1,0,1,1,2,5,,0,0,0,,1,0,0,0,0,0,6,20,27,
1891,Dane Olsen,8,128,165,15,10,5,3,2,139,86.34,0,0,0,32.12,11,15,0,1,0,6,37,91,155,
1892,Josh Moore,11,149,160,7,4,3,7,2,76,,0,0,0,23.75,4,9,1,3,0,7,34,115,152,
1893,Joe Oaks,1,2,0,1,1,0,1,2,0,,0,0,0,,0,0,0,0,0,0,1,1,0,
1894,Donald Robinson,3,31,18,0,0,0,2,2,2,,13,13,0,,0,0,0,0,0,0,1,30,22,
1895,Brad Tinney,8,80,0,4,1,3,2,2,19,,0,0,0,,0,4,0,0,0,0,48,32,0,
1896,Keven Moldenhauer,7,102,62,5,3,2,3,2,35,,0,0,0,,1,3,0,3,0,0,9,93,83,
1897,Angelo Olcese,12,105,46,1,1,0,1,2,27,,301,173,128,,4,0,0,0,0,0,0,105,118,Hybrid
1898,Kevin Yngve,3,23,0,0,0,0,2,2,4,,0,0,0,,0,0,0,0,0,0,0,23,0,
1899,Nick Patel,27,529,551,42,22,20,12,2,370,88.1,556,173,383,35.93,27,43,0,9,0,6,197,332,523,Handler
1900,Ben Hubbard,12,182,179,12,6,6,7,2,85,85.0,0,0,0,37.99,6,14,0,3,0,6,69,113,187,
1901,Greg Mohler,8,100,148,10,6,4,1,2,79,,19,1,18,47.97,10,7,0,2,0,0,84,16,132,Cutter
1902,Suraj Madiraju,7,81,45,4,2,2,1,2,22,,206,57,149,,3,2,0,1,0,0,0,81,90,Cutter
1903,Tim Posl,2,43,55,4,3,1,2,2,36,,0,0,0,,4,4,0,0,0,0,39,4,28,
1904,Julien Sénéchal,9,106,72,3,1,2,2,2,23,,336,109,227,,1,3,0,0,0,2,15,91,132,
1905,James Yeager,18,232,178,12,11,1,2,2,183,91.04,0,0,0,47.19,13,12,0,0,0,61,51,181,200,
1906,Shawn Chua,1,13,8,2,0,2,0,2,1,,0,0,0,,1,0,0,0,0,0,0,13,9,
1907,Trent Dillon,7,14,0,6,1,5,3,2,46,,0,0,0,,0,5,0,2,0,0,8,6,0,
1908,Kyle Dreger,2,22,17,3,2,1,0,2,13,,50,58,-8,,0,1,0,0,0,0,0,22,23,
1909,Michael Bjevoluk,5,9,0,4,1,3,1,2,24,,0,0,0,,0,3,0,0,0,0,4,5,0,
1910,Alan Gruntz,10,122,49,4,1,3,0,2,7,,127,17,110,,0,2,0,0,0,1,2,120,129,
1911,Jake Tozer,4,36,34,3,1,2,3,2,7,,0,0,0,,0,3,0,1,0,0,3,33,34,
1912,Matt Hudspith,4,50,29,2,1,1,0,2,4,,0,0,0,,0,0,0,0,0,0,0,50,27,
1913,Levi Jeske,6,77,76,4,0,4,1,2,18,,0,0,0,,1,0,0,3,0,0,38,39,72,
1914,Francisco Gomez,6,69,56,1,1,0,3,2,7,,0,0,0,,2,1,0,1,0,0,15,54,76,Cutter
1915,John Tan,4,46,41,1,0,1,3,2,10,,212,34,178,,4,1,0,1,0,0,3,43,54,
1916,Dan Wang,7,62,0,6,4,2,4,2,44,,0,0,0,,0,6,0,2,0,0,18,44,0,
1917,Taylor Van Oosbree,1,14,0,1,0,1,1,2,1,,0,0,0,,0,0,0,0,0,0,2,12,0,
1918,Eric Guindon,4,42,0,0,0,0,2,2,9,,0,0,0,,0,0,1,0,0,0,8,34,0,
1919,Derek Yan,2,10,9,1,0,1,1,2,9,,0,0,0,,0,0,0,0,0,0,0,10,9,
1920,Colin Smith,5,48,42,5,2,3,0,2,19,,0,0,0,,0,2,0,1,0,7,11,37,38,
1921,Dylan Elder,8,61,33,3,2,1,1,2,14,,0,0,0,,0,2,0,0,0,0,6,55,40,
1922,Zachery Turner,6,56,27,3,1,2,2,2,13,,148,63,85,,1,2,0,1,0,0,5,51,60,
1923,Sean Maxcy,5,66,51,4,2,2,0,2,8,,0,0,0,,0,1,0,1,0,3,16,50,63,
1924,David Abram,9,157,99,6,2,4,2,2,79,,0,0,0,,2,6,0,0,0,0,8,149,132,
1925,Michael Finke,3,31,19,2,0,2,1,2,13,,97,-2,99,,1,0,0,1,0,0,0,31,31,
1926,Paul Tatulea,8,113,98,6,2,4,4,2,46,,0,0,0,,2,7,0,1,0,0,25,88,101,
1927,Matt McDonald,1,22,23,1,0,1,1,2,7,,92,32,60,,0,0,0,0,0,0,16,6,23,
1928,Charles-David Hendriks,1,10,10,2,0,2,0,2,1,,0,0,0,,0,0,0,0,0,0,1,9,9,
1929,Nick Ongpauco,11,134,0,13,10,3,6,2,164,93.18,0,0,0,,0,12,0,5,0,1,107,27,0,
1930,Kris Thomson,15,311,338,15,9,6,8,2,209,90.09,0,0,0,52.96,12,20,1,1,0,0,154,157,281,
1931,Daniel Viggiani,8,121,111,6,0,6,2,2,19,,12,10,2,21.62,1,4,0,2,0,3,58,63,130,
1932,Thomas Hansen,5,51,19,0,0,0,2,2,8,,86,-20,106,,1,0,0,0,0,0,3,48,55,
1933,Kelly Moses,2,9,0,0,0,0,2,2,0,,0,0,0,,0,0,0,0,0,0,0,9,0,
1934,Dan Cunningham,8,87,49,2,1,1,1,2,20,,120,43,77,,5,1,0,0,0,0,5,82,106,
1935,Nicholas Smith,25,309,201,14,12,2,7,2,132,87.42,0,0,0,36.32,10,15,0,4,0,12,29,280,257,
1936,Nick Raisch,6,137,163,11,7,4,1,2,112,92.56,0,0,0,50.92,9,9,0,1,0,5,104,33,119,
1937,Kevin O'Brien,5,54,24,2,2,0,0,2,10,,158,123,35,,1,0,0,0,0,1,0,54,53,
1938,Paul Klimkowski,10,198,260,11,7,4,6,2,239,94.84,0,0,0,45.38,20,13,0,2,0,0,180,18,197,Defender
1939,Alec Mathena,4,37,34,3,2,1,0,2,8,,0,0,0,,0,1,0,0,0,0,9,28,34,
1940,Samuel Bisson,5,57,35,0,0,0,2,2,1,,31,-7,38,,0,0,0,0,0,0,2,55,68,
1941,Eddie Finley,7,46,34,0,0,0,3,2,4,,60,4,56,,0,1,0,0,0,0,0,46,59,Defender
1942,Ricky Kirkpatrick,7,37,18,1,0,1,2,2,4,,49,-8,57,,0,0,0,1,0,0,0,37,47,Defender
1943,Dan Clement,3,39,17,1,1,0,3,2,6,,0,0,0,,0,2,0,0,0,0,0,39,28,
1944,Dylan B,2,22,11,0,0,0,2,2,1,,0,0,0,,0,0,0,0,0,0,3,19,14,
1945,Adam Paicely,13,182,178,9,2,7,1,2,46,,0,0,0,33.71,7,3,0,5,0,2,100,82,159,
1946,Ronnie Eder,4,56,30,2,0,2,0,2,7,,0,0,0,,1,0,0,0,0,0,3,53,40,
1947,Alex Pien,6,58,27,4,0,4,2,2,10,,195,67,128,,1,4,0,0,0,11,0,58,66,
1948,Colin Hinde,2,19,14,2,1,1,1,2,6,,0,0,0,,0,0,0,1,0,4,1,18,15,
1949,Chris Layden,1,11,12,0,0,0,2,2,9,,97,60,37,,1,0,0,0,0,0,0,11,17,
1950,Dex Dremann,3,39,20,2,0,2,1,2,6,,97,61,36,,0,1,0,0,0,2,0,39,38,
1951,Shintaro Tsukamoto,5,36,19,2,1,1,1,2,5,,0,0,0,,0,1,0,0,0,13,0,36,33,
1952,Dan McCune,32,376,344,19,11,8,6,2,353,93.88,0,0,0,34.59,17,21,0,2,0,0,233,143,292,
1953,Dwight Harris,10,114,0,41,20,21,2,2,191,86.82,0,0,0,,0,29,0,12,0,0,47,67,0,
1954,Dan Casey,8,40,0,17,10,7,3,2,153,90.0,0,0,0,,0,17,0,1,0,0,20,20,0,
1955,Matt Baum,19,191,142,35,24,11,8,2,265,87.17,0,0,0,37.32,7,38,0,3,0,31,52,139,138,
1956,Davis Mossman,3,50,45,2,1,1,2,2,17,,0,0,0,,4,1,0,1,0,0,12,38,48,
1957,Zach Thurston,14,277,0,12,8,4,11,2,230,92.74,0,0,0,,0,18,0,3,0,43,83,194,0,
1958,Andrew Aylward,1,2,0,0,0,0,3,2,6,,0,0,0,,0,1,0,0,0,0,1,1,0,
1959,Saurov Dubey,7,74,44,2,1,1,1,2,9,,0,0,0,,0,1,0,0,0,0,5,69,66,Defender
1960,Adam Miller,8,102,65,3,3,0,2,2,45,,525,414,111,,3,3,0,0,0,4,10,92,109,
1961,K Hartl,1,15,16,2,1,1,1,2,3,,0,0,0,,0,0,0,1,0,0,3,12,11,
1962,Eric Clarkson,3,27,0,2,1,1,3,2,9,,0,0,0,,0,3,0,0,0,0,6,21,0,
1963,Andrew Roca,7,105,92,11,10,1,2,2,102,88.7,0,0,0,,4,10,0,1,0,0,31,74,95,
1964,Chuck Hippman,4,19,21,1,0,1,2,2,4,,0,0,0,,0,1,0,0,0,0,4,15,24,
1965,Felix Marceau,8,116,100,6,2,4,2,2,13,,0,0,0,28.0,2,3,0,3,0,69,24,92,98,
1966,Rob S,1,12,10,3,3,0,0,2,11,,0,0,0,,0,1,0,0,0,0,1,11,13,
1967,Abe Gambert,7,71,70,1,0,1,4,2,37,,0,0,0,,3,3,0,0,0,1,13,58,73,
1968,Mike Cramer,2,30,30,2,0,2,0,2,2,,0,0,0,,0,0,0,0,0,0,5,25,28,
1969,John Holk,3,42,27,1,0,1,1,2,2,,0,0,0,,0,0,0,0,0,0,4,38,43,
1970,Ryan Sheppard,2,14,5,2,0,2,0,2,1,,43,1,42,,0,0,0,0,0,0,0,14,12,
1971,Xavier Payne,46,1085,1094,89,71,18,29,2,1256,90.17,3463,3256,207,35.56,58,112,0,4,0,422,529,556,1073,Handler
1972,Eli Mock,5,46,27,2,0,2,1,2,4,,77,7,70,,0,1,0,0,0,0,2,44,51,
1973,Tyler Thomegreene,8,104,95,7,3,4,2,2,66,,338,292,46,,8,5,0,2,0,11,22,82,111,
1974,Justin Kinkead,7,61,44,2,1,1,1,2,8,,0,0,0,,1,0,0,1,0,0,4,57,57,
1975,Justin Mattingly,3,33,18,1,0,1,2,2,4,,0,0,0,,0,1,0,0,0,0,4,29,28,
1976,Josh Lowell,12,223,0,24,9,15,8,2,220,88.35,0,0,0,,0,28,1,2,0,4,112,111,0,
1977,Brett Hidaka,13,184,183,12,9,3,12,2,218,88.98,462,394,68,32.79,13,20,1,2,0,0,58,126,196,
1978,Max Carpenter,1,13,9,0,0,0,2,2,1,,-1,-1,0,,0,0,0,0,0,0,0,13,11,
1979,Eli Park,2,22,10,2,0,2,1,2,5,,35,20,15,,1,1,0,0,0,1,0,22,29,
1980,Ed Fox,15,215,287,17,15,2,3,2,296,91.93,0,0,0,39.02,13,17,0,1,0,0,192,23,246,
1981,Josef Van Kan,2,26,38,2,1,1,2,2,16,,0,0,0,,3,0,0,2,0,0,23,3,34,
1982,Max Perham,1,12,10,1,1,0,1,2,5,,0,0,0,,0,0,0,0,0,0,0,12,8,
1983,Matt Kishi,5,43,24,1,0,1,3,1,10,,88,8,80,,0,2,0,1,0,0,1,42,50,
1984,Nicholas Whale,6,60,50,0,0,0,2,1,11,,0,0,0,,1,1,0,0,0,0,7,53,52,
1985,Joseph Kennedy,3,27,12,1,1,0,0,1,12,,156,93,63,,0,0,0,0,0,0,0,27,36,
1986,Jon Fey,2,21,13,1,0,1,0,1,2,,0,0,0,,0,0,0,0,0,0,5,16,21,
1987,Jay Boyle,2,20,16,1,1,0,0,1,8,,0,0,0,,0,0,0,0,0,2,6,14,17,
1988,Matt Gubernick,3,26,18,1,0,1,0,1,3,,94,39,55,,0,0,0,0,0,0,0,26,29,
1989,Hye-Nam Gehring,7,41,0,2,0,2,2,1,4,,0,0,0,,0,1,0,2,0,0,11,30,0,
1990,Matteo Focchi,3,18,13,0,0,0,1,1,3,,41,14,27,,0,0,0,0,0,0,3,15,23,
1991,Zach Saffa,5,71,54,2,1,1,2,1,16,,0,0,0,,3,2,0,1,0,10,14,57,58,
1992,Christopher Grimm,2,20,9,1,1,0,0,1,6,,0,0,0,,0,0,0,0,0,0,1,19,14,
1993,Sam Lee,15,170,183,13,6,7,4,1,203,94.42,0,0,0,40.44,2,11,0,5,0,1,101,69,166,
1994,Corey McCall,4,34,25,2,0,2,0,1,9,,0,0,0,,1,0,0,1,0,0,10,24,27,
1995,Josh Feng,4,50,44,4,2,2,0,1,33,,0,0,0,,1,2,0,1,0,1,4,46,48,
1996,Alijah Crowe,2,14,13,1,0,1,0,1,1,,0,0,0,,0,0,0,0,0,0,0,14,11,
1997,Greg Husak,10,178,174,21,12,9,3,1,176,88.0,0,0,0,46.55,18,22,0,1,0,7,104,74,166,
1998,Raj Maitra,8,90,48,3,2,1,1,1,27,,0,0,0,,3,1,0,2,0,0,7,83,56,
1999,Lauren Doyle,2,21,25,1,0,1,0,1,12,,0,0,0,,0,0,0,0,0,0,21,0,18,
2000,Vincent Genest,6,55,36,3,0,3,0,1,2,,86,-11,97,,0,0,0,2,0,0,0,55,72,
2001,Robert Roos,5,64,56,5,3,2,1,1,14,,0,0,0,,2,5,0,0,0,2,16,48,67,
2002,Dmitry Suvorov,4,42,32,0,0,0,2,1,22,,0,0,0,,0,1,0,0,0,0,5,37,34,
2003,Anthony Kahn,11,175,137,8,5,3,5,1,33,,0,0,0,31.39,5,10,0,2,0,21,32,143,174,
2004,Etienne Blaszkewycz,3,29,23,0,0,0,1,1,3,,0,0,0,,0,0,0,0,0,0,3,26,21,
2005,AJ Lemons,1,11,4,0,0,0,1,1,0,,0,0,0,,0,0,0,0,0,0,1,10,7,
2006,Alistair Robb,13,209,228,5,3,2,6,1,98,90.74,0,0,0,35.53,9,8,0,2,0,0,120,89,186,
2007,Michael Ntende,2,20,12,0,0,0,1,1,1,,9,-13,22,,0,0,0,0,0,6,4,16,22,
2008,Aaron Bartlett,2,19,10,1,0,1,0,1,6,,47,-11,58,,0,0,0,0,0,0,0,19,23,
2009,Zac Byrnes,2,19,14,1,0,1,0,1,2,,0,0,0,,0,0,0,0,0,1,1,18,13,
2010,Barrett Wachholz,2,30,40,4,4,0,1,1,15,,0,0,0,,2,2,0,2,0,0,25,5,31,
2011,Matt Glenn,14,172,119,8,5,3,5,1,56,,0,0,0,31.09,2,9,0,3,0,43,49,123,127,
2012,Daniel Lee,1,10,10,1,1,0,0,1,4,,0,0,0,,0,0,0,0,0,0,4,6,10,
2013,Brian Howard,2,17,18,1,0,1,0,1,2,,0,0,0,,0,0,0,0,0,0,1,16,14,
2014,Nick Nugent,2,4,2,0,0,0,1,1,0,,0,0,0,,0,0,0,0,0,0,0,4,2,
2015,Sebastian Brauer,2,23,17,1,0,1,1,1,15,,17,36,-19,,0,0,0,1,0,6,0,23,23,
2016,Thomas Faber,2,27,28,1,0,1,0,1,4,,0,0,0,,0,0,0,0,0,0,15,12,20,
2017,Kevin Deangelis,6,63,29,2,1,1,3,1,7,,171,87,84,,2,4,0,0,0,19,3,60,60,
2018,Daniel Mah,1,12,8,1,0,1,0,1,2,,22,4,18,,0,0,0,0,0,0,0,12,12,
2019,Brian Street,8,46,27,2,2,0,1,1,21,,153,114,39,,2,2,0,0,0,12,8,38,39,
2020,Fletcher Hare,1,13,5,0,0,0,1,1,2,,34,16,18,,0,0,0,0,0,7,0,13,13,
2021,Jesse White,1,13,9,1,0,1,0,1,6,,0,0,0,,0,0,0,0,0,0,3,10,12,
2022,Bobby Moyer,10,218,242,12,4,8,7,1,148,88.62,0,0,0,34.3,6,18,0,0,0,14,138,80,200,
2023,Rees McDevitt,10,109,76,3,1,2,3,1,51,,362,266,96,,2,2,0,3,0,0,32,77,126,
2024,Lexa Stambaugh,2,29,19,2,1,1,0,1,8,,0,0,0,,0,0,0,1,0,0,8,21,19,
2025,Andrew Kramer,1,13,7,1,0,1,0,1,3,,0,0,0,,0,0,0,0,0,0,2,11,5,
2026,William Maroon,5,9,0,4,3,1,0,1,27,,0,0,0,,0,3,0,0,0,0,4,5,0,
2027,Henry Ing,1,25,14,1,1,0,0,1,6,,102,79,23,,0,0,0,0,0,0,3,22,25,
2028,Danny Bjorkman,9,127,127,11,7,4,3,1,84,,0,0,0,33.07,2,12,0,1,0,53,48,79,124,
2029,Tom Phillips,1,17,21,1,1,0,0,1,11,,0,0,0,,1,0,0,0,0,0,16,1,14,
2030,Ben Rehmann,5,78,78,5,3,2,3,1,43,,0,0,0,,4,4,0,3,0,1,33,45,81,
2031,Anish Indhupuru,4,37,19,1,1,0,0,1,4,,2,3,-1,,1,0,0,0,0,0,3,34,33,
2032,Ben Macalalad,3,33,16,1,0,1,0,1,1,,0,0,0,,0,0,0,0,0,0,4,29,28,
2033,Thomas McAlear,4,48,42,2,1,1,2,1,18,,0,0,0,,1,2,0,1,0,27,5,43,52,
2034,Henry Rodriguez,1,15,18,0,0,0,2,1,3,,0,0,0,,0,1,0,0,0,0,2,13,15,
2035,Zibi Braniecki,4,59,43,3,2,1,0,1,7,,0,0,0,,0,2,0,0,0,0,16,43,42,
2036,Zach Ormsby,4,46,20,1,0,1,0,1,7,,0,0,0,,1,0,0,0,0,0,1,45,34,
2037,Cody Johns,1,7,1,0,0,0,1,1,0,,0,0,0,,0,0,0,0,0,0,0,7,5,
2038,Zachary Cole,3,40,34,3,2,1,0,1,28,,140,121,19,,1,2,0,0,0,0,19,21,40,
2039,Charlie Eide,8,94,57,2,2,0,0,1,24,,0,0,0,,0,1,0,0,0,3,4,90,75,
2040,Benjamin Preiss,3,31,16,1,1,0,1,1,5,,0,0,0,,2,1,0,0,0,0,3,28,24,
2041,Paul Karavayev,8,90,102,3,0,3,5,1,12,,0,0,0,15.69,3,5,0,2,0,0,55,35,80,
2042,Noah Backer,1,17,21,1,0,1,1,1,14,,166,137,29,,2,1,1,0,0,0,15,2,18,
2043,Rodrigo Arcibar,1,9,3,1,0,1,0,1,1,,0,0,0,,0,0,0,0,0,0,1,8,6,
2044,Cameron Beck,6,87,75,1,0,1,3,1,31,,0,0,0,,1,2,0,1,0,2,11,76,77,
2045,Brad Jones,1,2,0,1,0,1,0,1,0,,0,0,0,,0,0,0,0,0,0,1,1,0,
2046,Andy Sammons,23,312,401,17,8,9,7,1,497,95.39,0,0,0,45.64,13,21,0,2,0,1,298,14,286,
2047,Adam Brown,1,7,1,1,0,1,0,1,0,,0,0,0,,0,0,0,0,0,0,0,7,1,
2048,Aaron Schwieterman,5,67,89,7,3,4,0,1,55,,533,151,382,,2,3,0,3,0,0,67,0,76,
2049,Scott Miller,2,16,7,1,0,1,0,1,3,,0,0,0,,0,0,0,0,0,0,0,16,9,
2050,Gerald Chizmadia,5,57,49,2,1,1,1,1,9,,0,0,0,,0,2,0,0,0,1,32,25,42,
2051,Stephane Carslisle,5,59,42,1,0,1,3,1,8,,0,0,0,,1,3,0,0,0,0,8,51,45,
2052,Josh McKisic,15,111,55,4,1,3,1,1,21,,15,-7,22,,2,2,0,2,0,1,14,97,81,
2053,Andy Theiss,4,5,0,2,2,0,0,1,6,,0,0,0,,0,1,0,0,0,0,3,2,0,
2054,Daniel Bates,9,68,50,4,3,1,2,1,41,,0,0,0,,7,5,0,0,0,8,19,49,52,Handler
2055,Josh Smith,1,14,14,1,0,1,1,1,6,,0,0,0,,0,1,0,0,0,0,9,5,13,
2056,Antoine Rousseau,7,99,52,3,1,2,2,1,43,,363,240,123,,4,4,0,0,0,2,5,94,104,
2057,Andrew Ryan,9,126,103,9,2,7,4,1,28,,0,0,0,34.95,3,11,0,1,0,24,15,111,104,
2058,Wyatt Berreman,1,8,5,0,0,0,1,1,0,,0,0,0,,0,0,0,0,0,0,0,8,7,
2059,Josh Greenough,2,21,19,1,0,1,0,1,5,,0,0,0,,0,0,0,0,0,0,3,18,20,
2060,Sef van Kan,2,24,33,2,2,0,0,1,12,,113,38,75,,0,1,0,0,0,0,22,2,29,Cutter
2061,Brian Wyer,1,15,7,0,0,0,2,1,4,,42,3,39,,0,0,0,1,0,0,0,15,14,
2062,David DiBiase,8,25,0,9,7,2,3,1,75,,0,0,0,,0,8,0,3,0,0,9,16,0,
2063,Elliot Deeds,1,11,9,0,0,0,1,1,1,,19,10,9,,0,0,0,0,0,0,0,11,12,
2064,Chase Hammond,14,267,235,14,8,6,6,1,151,90.42,0,0,0,31.49,6,16,1,3,0,20,82,185,235,
2065,Seokhee Burningham,7,132,170,9,3,6,4,1,47,,0,0,0,25.88,3,8,1,4,0,0,87,45,108,
2066,Zac Petty,4,57,42,3,0,3,0,1,24,,0,0,0,,0,2,0,0,0,2,14,43,58,
2067,Eddie Harmoush,14,264,244,19,13,6,5,1,170,88.54,0,0,0,45.08,10,21,1,2,0,102,115,149,224,
2068,Sean McCall,2,26,39,3,1,2,1,1,26,,0,0,0,,3,3,1,0,0,0,23,3,27,
2069,Tom LaRocco,8,20,0,7,1,6,2,1,46,,0,0,0,,0,7,0,1,0,0,9,11,0,
2070,Jackelyne Nguyen,1,17,9,0,0,0,1,1,0,,0,0,0,,0,0,0,0,0,0,2,15,11,
2071,Jeffrey Oravic,2,22,4,1,0,1,0,1,0,,20,0,20,,0,0,0,0,0,5,0,22,21,
2072,Mark Rauls,2,48,73,8,4,4,1,1,57,,0,0,0,,4,5,0,3,0,0,38,10,57,
2073,Caleb Posey,2,32,16,1,1,0,0,1,8,,163,76,87,,1,0,0,0,0,0,8,24,29,
2074,Isaac Davis,1,9,13,2,0,2,0,1,3,,0,0,0,,1,0,0,1,0,0,3,6,7,
2075,Austin Walker,5,61,51,3,3,0,2,1,23,,0,0,0,,2,4,0,0,0,4,15,46,58,
2076,Michael Rudy,4,5,0,2,1,1,0,1,7,,0,0,0,,0,1,0,0,0,0,2,3,0,
2077,Brandon Taitt,1,9,4,1,0,1,0,1,0,,0,0,0,,0,0,0,0,0,0,0,9,6,
2078,Mat Peltier,6,41,38,1,1,0,2,1,13,,0,0,0,,0,2,0,0,0,0,11,30,34,
2079,Colin Bilodeau,1,2,0,0,0,0,1,1,0,,0,0,0,,0,0,0,0,0,0,1,1,0,
2080,Tom Grund,6,51,40,2,2,0,0,1,26,,0,0,0,,0,1,1,0,0,0,9,42,43,
2081,Mick Stukes,3,38,32,3,1,2,0,1,8,,0,0,0,,1,2,0,0,0,0,17,21,32,
2082,Ryan Cicioni,13,137,89,2,0,2,4,1,22,,0,0,0,,1,3,0,2,0,0,30,107,122,
2083,Clayton Carey,2,20,6,0,0,0,1,1,1,,19,14,5,,0,0,0,0,0,0,0,20,15,
2084,David Adams,1,21,11,1,1,0,0,1,5,,0,0,0,,0,0,0,0,0,0,1,20,13,
2085,Mike K,1,12,8,1,0,1,0,1,0,,0,0,0,,0,0,0,0,0,0,6,6,7,
2086,Mark Schimmel,5,32,14,0,0,0,1,1,10,,0,0,0,,2,0,0,0,0,0,0,32,19,
2087,Steven Broome,3,51,51,4,1,3,2,1,21,,0,0,0,,2,3,0,2,0,0,17,34,55,
2088,Charlie Reiff,1,13,11,1,1,0,0,1,3,,0,0,0,,1,0,0,0,0,0,9,4,6,
2089,Simon Walker,5,48,34,2,1,1,2,1,12,,45,22,23,,0,2,0,1,0,2,2,46,48,
2090,Kevin Goldberg,7,56,44,1,1,0,1,1,31,,297,184,113,,4,0,0,1,0,11,4,52,82,Defender
2091,Chris Grener,9,69,0,4,1,3,1,1,16,,0,0,0,,0,3,0,1,0,0,24,45,0,
2092,Kyle Nichols-Schmolze,8,26,0,8,7,1,0,1,41,,0,0,0,,0,5,0,2,0,0,14,12,0,
2093,Jake Pruitt,3,46,49,4,3,1,3,1,33,,0,0,0,,2,5,0,1,0,0,10,36,40,Cutter
2094,Ferdia Rogers,3,20,11,0,0,0,1,1,3,,0,0,0,,1,0,0,0,0,0,2,18,12,
2095,Jack Hamner,1,16,11,0,0,0,1,1,1,,0,0,0,,0,0,0,0,0,0,3,13,12,
2096,Stephanie Pritchard,4,74,84,3,0,3,0,1,14,,0,0,0,,2,2,0,0,0,0,63,11,53,
2097,Nick Howard,4,7,0,3,1,2,2,1,26,,0,0,0,,0,4,0,0,0,0,3,4,0,
2098,Max Charles,7,115,138,11,8,3,0,1,126,91.3,1443,855,588,55.07,4,10,0,0,0,0,108,7,124,
2099,Matthew Johnson,1,3,5,1,0,1,0,1,1,,73,-5,78,,0,0,0,0,0,0,0,3,6,
2100,Michael Serota,1,2,0,1,1,0,0,1,0,,0,0,0,,0,0,0,0,0,0,1,1,0,
2101,Charles Robertson,2,31,30,3,1,2,1,1,6,,0,0,0,,0,2,0,1,0,0,10,21,24,
2102,Tre Hodge,2,21,11,0,0,0,1,1,0,,0,0,0,,0,0,0,0,0,0,5,16,16,
2103,Charlie Mercer,6,97,80,6,3,3,0,1,26,,0,0,0,,5,4,0,1,0,2,44,53,79,
2104,Ben Souvey,1,23,16,0,0,0,1,1,8,,0,0,0,,0,0,0,0,0,0,6,17,18,
2105,Joe Young,9,164,238,16,11,5,2,1,315,94.31,0,0,0,41.18,12,14,2,3,0,6,131,33,193,
2106,Joe Rogers,5,108,117,5,0,5,1,1,73,,0,0,0,42.74,4,4,0,1,0,10,75,33,115,
2107,Jake Lochhead,2,32,35,3,3,0,0,1,18,,370,311,59,,3,2,0,0,0,7,22,10,40,
2108,Jacob Komenda,2,30,10,0,0,0,1,1,2,,0,0,0,,0,0,0,0,0,1,3,27,22,
2109,Simon Montague,9,203,261,28,22,6,2,1,228,88.03,0,0,0,50.57,19,27,0,2,0,3,175,28,192,
2110,Julian Gallo,2,21,21,0,0,0,1,1,2,,0,0,0,,0,0,0,0,0,1,1,20,20,
2111,Chris Brooks,18,340,359,20,11,9,6,1,245,90.07,0,0,0,42.9,15,23,0,2,0,92,162,178,302,
2112,Nicolas LoPresto,1,11,0,1,0,1,1,1,2,,0,0,0,,0,0,0,1,0,0,2,9,0,
2113,Tommy Lin,19,227,144,4,2,2,2,1,53,,334,250,84,34.72,4,3,0,2,0,0,10,217,227,Handler
2114,Kevin Souser,2,4,0,2,0,2,3,1,27,,0,0,0,,0,3,0,1,0,0,2,2,0,
2115,Ethan Bolthouse,1,12,12,2,0,2,0,1,9,,107,1,106,,1,0,0,1,0,8,0,12,14,Cutter
2116,Nick Schlag,1,26,36,4,3,1,0,1,56,,0,0,0,,3,3,0,0,0,0,23,3,26,
2117,Ryan Smith,10,134,137,13,4,9,4,1,110,88.0,0,0,0,45.26,7,14,0,2,0,3,22,112,137,
2118,Ben Jones,12,238,292,20,10,10,8,1,223,88.14,0,0,0,24.32,12,21,1,6,0,6,143,95,180,
2119,Justin Keller,2,35,25,1,0,1,1,1,25,,144,79,65,,4,1,0,0,0,0,0,35,43,
2120,Chris Ellis,3,22,14,1,0,1,1,1,0,,40,0,40,,0,1,0,0,0,0,3,19,27,
2121,Brett Egger,6,103,100,7,4,3,2,1,96,92.31,0,0,0,41.0,6,7,0,1,0,0,36,67,99,
2122,Tait Becke,1,14,8,1,0,1,0,1,0,,0,0,0,,0,0,0,0,0,0,1,13,6,
2123,Michael Huang,1,13,6,1,0,1,0,1,6,,54,0,54,,1,0,0,0,0,0,0,13,14,
2124,Skylar Brunner,25,242,39,19,12,7,15,1,251,89.01,0,0,0,,0,28,0,5,0,1,101,141,40,
2125,Bryce Carleton,1,11,4,1,0,1,0,1,1,,0,0,0,,0,0,0,0,0,0,1,10,6,
2126,Jeff Holm,3,49,31,2,2,0,0,1,13,,0,0,0,,1,1,0,0,0,0,21,28,36,
2127,Ben Gagne-Maynard,11,154,89,3,1,2,2,1,23,,343,-10,353,,3,4,0,0,0,0,0,154,195,
2128,Tyler Chiu,3,41,36,0,0,0,1,1,4,,0,0,0,,0,0,0,0,0,0,6,35,40,
2129,Michael Juratovac,1,2,0,0,0,0,3,1,18,,0,0,0,,0,2,0,0,0,0,1,1,0,
2130,James Pollard,4,58,49,0,0,0,2,1,26,,0,0,0,,2,1,0,0,0,3,20,38,51,
2131,Craig Cox,1,5,8,1,1,0,2,1,3,,0,0,0,,0,2,0,0,0,0,3,2,6,
2132,Elijah Grady,4,52,35,1,0,1,1,1,13,,0,0,0,,4,1,0,0,0,1,13,39,40,
2133,Greg Garbern,7,46,60,3,1,2,1,0,11,,0,0,0,,0,2,0,2,0,0,28,18,44,
2134,Peter Schmitt,2,7,6,0,0,0,0,0,2,,0,0,0,,0,0,0,0,0,1,3,4,5,
2135,Sam Ross,6,47,0,1,1,0,2,0,23,,0,0,0,,0,3,1,0,0,0,2,45,0,
2136,Michael Woolley,6,71,92,4,0,4,1,0,15,,0,0,0,,1,2,0,3,0,0,54,17,60,
2137,Benjamin Thompsen,1,10,3,0,0,0,0,0,0,,0,0,0,,0,0,0,0,0,0,0,10,6,
2138,Erich Phang-Lynn,14,137,78,3,2,1,1,0,30,,83,56,27,,2,4,0,0,0,0,11,126,133,
2139,Madison Head,1,12,4,0,0,0,0,0,1,,44,13,31,,0,0,0,0,0,0,0,12,14,
2140,Mike Mansfield,7,128,195,11,5,6,8,0,92,88.46,0,0,0,24.1,5,11,0,8,0,0,90,38,140,
2141,Max Grove,1,1,1,0,0,0,0,0,0,,0,0,0,,0,0,0,0,0,0,0,1,1,
2142,Stephen Magerr,20,220,157,15,3,12,4,0,112,88.19,0,0,0,24.84,4,11,1,8,0,0,94,126,126,
2143,Craig McGowan,7,121,111,3,1,2,5,0,82,,0,0,0,32.43,4,8,0,0,0,0,38,83,123,
2144,Sam Murphy,3,24,15,0,0,0,2,0,3,,0,0,0,,0,1,0,1,0,0,4,20,25,
2145,Ryan Ntende,4,33,17,0,0,0,0,0,6,,59,10,49,,0,0,0,0,0,1,5,28,29,
2146,Lucas Tarnowski,1,11,0,1,0,1,1,0,9,,0,0,0,,0,1,0,1,0,0,11,0,0,
2147,Ben Pavelka,3,27,18,1,1,0,0,0,23,,0,0,0,,3,1,0,0,0,6,6,21,20,Handler
2148,Ben Jansen,20,229,163,8,4,4,5,0,44,,0,0,0,23.93,1,8,1,5,0,98,25,204,199,
2149,Kyle Johnson,10,106,74,1,0,1,1,0,14,,237,27,210,,1,1,0,1,0,0,2,104,134,
2150,Christian Simpson,6,119,169,20,12,8,3,0,167,86.08,0,0,0,40.83,12,21,3,2,0,1,104,15,134,
2151,Andy Nielsen,6,69,75,3,2,1,1,0,46,,0,0,0,,1,3,0,1,0,0,34,35,57,
2152,Dan Huebner,2,7,0,0,0,0,0,0,3,,0,0,0,,0,0,0,0,0,0,0,7,0,
2153,Javier Yañez,2,34,48,5,5,0,0,0,71,,675,557,118,,1,4,1,1,0,0,34,0,40,
2154,Aaron Ziegler,5,8,0,3,1,2,3,0,42,,0,0,0,,0,6,0,0,0,0,3,5,0,
2155,Tim Johnson,4,5,0,2,2,0,2,0,28,,0,0,0,,0,3,0,1,0,0,2,3,0,
2156,Jacob Price,25,301,90,34,28,6,9,0,314,89.46,0,0,0,,4,36,0,7,0,79,102,199,134,Defender
2157,Mohamadou Diatta,2,18,21,2,0,2,0,0,4,,0,0,0,,2,2,0,0,0,0,3,15,27,
2158,David Danks,1,6,1,0,0,0,0,0,0,,0,0,0,,0,0,0,0,0,0,0,6,1,
2159,Jacob Shoyer,1,4,2,0,0,0,0,0,0,,0,0,0,,0,0,0,0,0,0,0,4,13,Hybrid
2160,Taylor Lahey,25,529,573,36,26,10,5,0,631,93.34,0,0,0,38.92,36,36,3,5,0,5,213,316,532,
2161,Scott Boehm,0,0,0,0,0,0,0,0,0,,0,0,0,,0,0,0,0,0,0,0,0,0,
2162,Derek Fan,4,47,30,1,1,0,0,0,14,,0,0,0,,1,1,0,0,0,0,6,41,46,
2163,Bailey LaBerteaux,1,14,11,1,1,0,0,0,8,,110,96,14,,0,1,0,0,0,0,0,14,12,
2164,Milan Rivas,5,64,45,2,1,1,0,0,34,,215,95,120,,4,2,0,0,0,0,1,63,74,
2165,Mike Miller,1,5,2,0,0,0,0,0,0,,0,0,0,,0,0,0,0,0,3,0,5,4,
2166,Ben Krumpelman,3,22,12,0,0,0,0,0,3,,0,0,0,,0,0,0,0,0,0,0,22,17,
2167,Tony Lopez,5,82,98,8,2,6,0,0,49,,792,146,646,,6,5,0,3,0,0,71,11,79,
2168,Justin Kinkead,3,59,76,6,4,2,0,0,102,93.58,0,0,0,,10,6,0,0,0,0,54,5,56,
2169,Elliot Warner,1,13,6,0,0,0,0,0,2,,0,-7,7,,0,0,0,0,0,0,0,13,11,
2170,Jessie Jones,1,14,12,0,0,0,0,0,2,,0,0,0,,0,0,0,0,0,0,0,14,10,
2171,Brett Gramann,7,104,108,6,4,2,3,0,90,90.0,0,0,0,38.89,10,9,0,0,0,11,30,74,88,
2172,Anthony Monescalchi,6,79,51,3,0,3,0,0,11,,0,0,0,,2,1,0,2,0,0,14,65,58,
2173,Michael Fioramonti,7,60,31,1,0,1,3,0,17,,0,0,0,,2,1,0,3,0,0,2,58,43,
2174,Ben Gerroll,8,78,82,7,4,3,2,0,42,,0,0,0,,5,8,0,1,0,2,15,63,80,
2175,James Greeno,9,106,88,5,2,3,0,0,63,,0,0,0,,5,5,0,0,0,0,5,101,100,
2176,Hai Trang,1,17,7,0,0,0,0,0,1,,0,0,0,,0,0,0,0,0,0,3,14,13,
2177,Jay Kinzel,8,214,290,27,21,6,3,0,256,87.07,0,0,0,32.76,6,29,0,1,0,7,187,27,212,Cutter
2178,Andrew McCrae,3,21,32,1,0,1,0,0,24,,0,0,0,,0,0,0,1,0,0,16,5,34,
2179,Ian Barry,12,246,296,11,1,10,5,0,351,94.61,0,0,0,41.89,29,13,0,3,1,0,185,61,245,
2180,Aaron Shi,12,184,171,9,4,5,4,0,109,90.08,0,0,0,38.6,5,12,0,1,0,31,54,130,180,
2181,Rafael Castro,1,11,5,0,0,0,0,0,0,,0,0,0,,0,0,0,0,0,0,1,10,9,
2182,John Buss,20,229,171,8,6,2,5,0,145,91.19,18,7,11,29.24,11,11,0,2,0,83,58,171,226,
2183,Andre Bordelon,2,18,12,0,0,0,0,0,4,,32,-2,34,,0,0,0,0,0,2,4,14,21,
2184,Neil Proefrock,2,5,4,0,0,0,0,0,3,,0,0,0,,0,0,0,0,0,0,0,5,4,
2185,Mitchell DeNooyer,4,41,20,1,1,0,0,0,5,,0,0,0,,1,1,0,0,0,3,7,34,30,
2186,Cecil Qiu,5,79,115,6,2,4,3,0,33,,0,0,0,33.04,5,7,0,2,0,0,33,46,85,
2187,Evan Valdes,2,14,7,0,0,0,0,0,0,,0,0,0,,0,0,0,0,0,0,1,13,10,
2188,Cole Robinette,1,2,0,1,0,1,0,0,6,,0,0,0,,0,1,0,0,0,0,1,1,0,
2189,Daniel Poindexter,8,125,158,8,5,3,3,0,97,90.65,0,0,0,44.94,13,10,0,1,0,0,83,42,115,
2190,Coleman Tappero,1,17,10,0,0,0,0,0,7,,0,0,0,,0,0,0,0,0,0,1,16,12,
2191,Eric Yoon,11,79,73,4,3,1,2,0,22,,0,0,0,,0,3,0,3,0,0,33,46,66,
2192,Nick Nagel,3,29,7,0,0,0,0,0,0,,6,0,6,,0,0,0,0,0,0,0,29,19,
2193,John Klaassen,9,102,115,8,6,2,2,0,62,,0,0,0,37.39,1,7,0,3,0,1,31,71,103,
2194,Josh Graber,1,12,0,0,0,0,0,0,0,,0,0,0,,0,0,0,0,0,0,0,12,5,
2195,Dustin Becker,5,17,5,0,0,0,0,0,0,,0,0,0,,0,0,0,0,0,0,1,16,15,
2196,Corey Bennett,1,5,0,0,0,0,0,0,0,,0,0,0,,0,0,0,0,0,0,0,5,2,
2197,J Bender,1,1,1,0,0,0,0,0,1,,0,0,0,,0,0,0,0,0,0,0,1,1,
2198,Chris Peak,1,10,3,0,0,0,0,0,0,,0,0,0,,0,0,0,0,0,0,0,10,4,
2199,Natasha Won,1,17,24,0,0,0,0,0,14,,0,0,0,,4,0,0,0,0,0,16,1,14,
2200,Mike Ball,4,54,23,1,1,0,1,0,16,,0,0,0,,1,2,0,0,0,0,2,52,37,
2201,Adam Lapikas,1,10,3,0,0,0,0,0,0,,0,0,0,,0,0,0,0,0,0,1,9,5,
2202,Grady Watkins,1,12,4,0,0,0,0,0,4,,65,30,35,,1,0,0,0,0,0,0,12,10,
2203,Liam Rosen,4,46,26,1,1,0,1,0,12,,0,0,0,,1,1,0,1,0,0,5,41,41,
2204,Andrew Schwartz,3,12,0,1,1,0,0,0,4,,0,0,0,,0,1,0,0,0,0,0,12,0,
2205,Cam Bellando,2,24,7,0,0,0,0,0,2,,-3,-4,1,,0,0,0,0,0,0,1,23,16,
2206,Kyle Dew,1,9,4,0,0,0,0,0,1,,0,0,0,,0,0,0,0,0,1,0,9,7,Hybrid
2207,BJ Barrett,4,22,26,1,1,0,0,0,6,,108,2,106,,2,0,0,1,0,0,19,3,21,
2208,Dean Stupar,1,9,5,0,0,0,0,0,0,,0,0,0,,0,0,0,0,0,0,0,9,10,
2209,Sascha Vogel,1,12,7,0,0,0,1,0,2,,15,21,-6,,0,1,0,0,0,6,0,12,11,
2210,Sam Brecker,2,7,3,0,0,0,0,0,1,,0,0,0,,0,0,0,0,0,0,0,7,3,
2211,Robby Odum,3,14,13,0,0,0,0,0,2,,17,9,8,,0,0,0,0,0,0,0,14,17,Defender
2212,Sam Diffin,2,31,31,0,0,0,1,0,28,,231,162,69,,2,0,0,1,0,0,19,12,35,
2213,Joshuah Kapilivsky,1,7,5,0,0,0,0,0,0,,0,0,0,,0,0,0,0,0,0,0,7,5,
2214,Vivek Devaraj,8,52,5,4,1,3,2,0,31,,0,0,0,,1,5,0,1,0,0,5,47,5,
2215,Clark Wang,3,26,25,0,0,0,0,0,6,,21,21,0,,1,0,0,0,0,0,0,26,36,Cutter
2216,Christopher Bernard,1,9,3,0,0,0,0,0,0,,0,0,0,,0,0,0,0,0,0,0,9,5,
2217,Matthew Hankin,5,73,65,3,1,2,1,0,37,,0,0,0,,4,1,0,3,0,17,29,44,67,
2218,Cody Kirkland,39,720,639,48,37,11,10,0,538,89.82,0,0,0,40.53,35,56,1,2,1,343,255,465,643,
2219,Thomas Anderson,1,15,5,0,0,0,0,0,0,,0,0,0,,0,0,0,0,0,0,0,15,14,
2220,Stephen Guerin,1,11,16,1,0,1,2,0,3,,0,0,0,,0,3,0,0,0,2,0,11,16,
2221,Richard VanAmburg,1,2,0,1,0,1,1,0,15,,0,0,0,,0,2,0,0,0,0,1,1,0,
2222,Sasha S,3,11,10,0,0,0,0,0,2,,0,0,0,,1,0,0,0,0,0,0,11,9,
2223,Sam Gabrielson,5,61,29,1,0,1,0,0,21,,44,19,25,,3,1,0,0,0,0,1,60,48,
2224,Evan Priest,11,97,102,7,5,2,6,0,54,,0,0,0,17.65,2,10,0,3,0,0,19,78,94,
2225,Robert Hunt,1,10,3,0,0,0,0,0,1,,0,0,0,,0,0,0,0,0,0,1,9,7,
2226,Jason Jaskiewicz,1,3,3,0,0,0,0,0,1,,0,0,0,,0,0,0,0,0,1,1,2,1,
2227,Jake McKean,9,117,0,5,4,1,5,0,82,,0,0,0,,0,8,0,2,0,2,35,82,0,
2228,Ruo Ye,20,201,194,15,6,9,4,0,166,92.22,0,0,0,38.66,9,14,1,5,0,19,48,153,194,
2229,Mike McClain,1,1,0,0,0,0,0,0,0,,0,0,0,,0,0,0,0,0,0,0,1,0,
2230,Kevin Liu,7,87,89,0,0,0,3,0,40,,0,0,0,,2,2,0,1,0,1,33,54,94,
2231,Marquis Chapman,4,12,6,0,0,0,0,0,0,,0,0,0,,0,0,0,0,0,0,3,9,5,
2232,Kyle Olson,6,50,30,1,0,1,0,0,10,,0,0,0,,1,1,0,0,0,0,5,45,35,
2233,Craig Manahan,3,39,41,0,0,0,3,0,11,,0,0,0,,1,1,0,2,0,0,6,33,37,
2234,Vehro Titcomb,3,44,45,2,1,1,0,0,10,,0,0,0,,1,2,0,0,0,2,24,20,32,
2235,Aaron Weaver,7,80,56,3,1,2,3,0,13,,0,0,0,,3,2,0,4,0,0,7,73,91,Hybrid
2236,Robert Jones,1,8,6,0,0,0,0,0,0,,18,0,18,,0,0,0,0,0,0,2,6,7,
2237,Tyrell Adair,7,103,108,1,0,1,2,0,21,,0,0,0,22.22,2,1,0,2,0,0,64,39,68,
2238,Elias Griffin,1,5,2,0,0,0,0,0,0,,0,0,0,,0,0,0,0,0,0,0,5,6,Defender
2239,Christian Gaffney,1,2,0,0,0,0,0,0,0,,0,0,0,,0,0,0,0,0,0,1,1,0,
2240,Ellen Rim,1,10,4,0,0,0,1,0,0,,0,0,0,,0,1,0,0,0,0,1,9,6,
2241,Matty Sung,2,15,7,0,0,0,0,0,1,,0,0,0,,0,0,0,0,0,0,1,14,8,
2242,Jimmy O'Connell,5,42,21,1,1,0,0,0,14,,0,0,0,,2,1,0,0,0,9,4,38,40,
2243,Ben Petrowski,4,35,26,3,2,1,0,0,10,,149,-11,160,,1,2,1,1,0,0,1,34,38,
2244,Peter Johnson,2,21,19,0,0,0,1,0,0,,11,0,11,,0,1,0,0,0,0,8,13,23,Cutter
2245,Connor Boyle,5,87,126,10,8,2,1,0,128,91.43,308,238,70,42.06,7,11,0,0,0,0,78,9,108,Handler
2246,Paul Burt,2,16,3,0,0,0,0,0,0,,0,0,0,,0,0,0,0,0,0,0,16,8,
2247,Nolan Howard,12,230,194,6,1,5,6,0,43,,0,0,0,21.13,4,11,0,1,0,0,74,156,195,Cutter
2248,Phil Bowen,1,5,2,0,0,0,0,0,0,,0,0,0,,0,0,0,0,0,0,0,5,1,
2249,Jack Lokowich,2,15,18,0,0,0,2,0,1,,0,0,0,,0,0,0,2,0,0,1,14,18,
2250,Jimi O'Connell,2,22,6,0,0,0,0,0,4,,20,23,-3,,0,0,0,0,0,15,2,20,27,Hybrid
2251,John I,5,37,45,2,1,1,2,0,17,,0,0,0,,0,4,0,0,0,0,15,22,40,
2252,Austin Ambrose,1,1,1,0,0,0,0,0,0,,0,0,0,,0,0,0,0,0,0,1,0,0,
2253,Grant Franke,1,12,7,0,0,0,0,0,3,,0,0,0,,0,0,0,0,0,0,4,8,7,
2254,Michael Dillard,1,11,1,0,0,0,0,0,2,,12,17,-5,,0,0,0,0,0,0,0,11,9,
2255,Wyatt Kellman,2,35,11,1,0,1,0,0,5,,38,40,-2,,1,1,0,0,0,0,0,35,33,
2256,Ben Miller,2,17,5,0,0,0,0,0,4,,0,0,0,,0,0,0,0,0,0,1,16,9,
2257,Andrew Foley,9,90,0,3,2,1,1,0,27,,0,0,0,,0,3,0,1,0,2,18,72,0,
2258,Xtian Guerrero,1,24,19,3,2,1,0,0,9,,0,0,0,,0,2,0,1,0,0,9,15,21,
2259,Tyler Kinley,2,16,13,1,1,0,0,0,5,,0,0,0,,0,1,0,0,0,0,3,13,14,
2260,Miles Eckardt,1,2,0,0,0,0,0,0,0,,0,0,0,,0,0,0,0,0,0,0,2,0,
2261,Mark Sandberg,10,176,187,4,3,1,2,0,116,94.31,0,0,0,32.62,5,5,0,1,0,0,122,54,139,
2262,Eric Hytönen,1,9,7,1,1,0,0,0,4,,0,0,0,,1,1,0,0,0,0,0,9,7,
2263,Zubair Abdulla,19,175,99,9,5,4,1,0,144,94.12,258,234,24,,3,8,0,2,0,4,50,125,113,
2264,Andrew McRae,1,1,0,0,0,0,0,0,0,,0,0,0,,0,0,0,0,0,0,0,1,0,
2265,JC Cox,2,27,26,2,1,1,0,0,25,,234,137,97,,2,2,0,0,0,0,15,12,26,
2266,Will Cernanec,1,7,0,1,0,1,0,0,0,,0,0,0,,0,0,0,1,0,1,3,4,0,
2267,Ryan Carver,3,28,29,0,0,0,0,0,4,,0,0,0,,1,0,0,0,0,0,17,11,13,
2268,Hudson Cogswell,1,2,1,0,0,0,0,0,0,,0,0,0,,0,0,0,0,0,0,0,2,0,
2269,Eli Graves,3,54,43,5,2,3,0,0,18,,0,0,0,,2,4,0,1,0,0,18,36,38,
2270,Josh Mull,4,43,0,2,1,1,0,0,23,,0,0,0,,0,1,0,1,0,1,13,30,0,
2271,Benjamin Attal,1,13,3,0,0,0,0,0,0,,0,0,0,,0,0,0,0,0,0,2,11,8,
2272,Alex Bertoia,14,265,269,12,7,5,6,0,200,91.32,0,0,0,31.23,12,17,1,1,0,3,136,129,283,
2273,Michael A,1,6,6,0,0,0,0,0,0,,0,0,0,,0,0,0,0,0,0,0,6,6,
2274,Tyler Reinhardt,1,14,8,0,0,0,0,0,2,,9,-10,19,,0,0,0,0,0,0,0,14,13,
2275,Benjamin Sokolowsky,6,70,57,3,3,0,0,0,71,,565,544,21,,9,3,0,0,0,19,17,53,82,Handler
2276,John Boezi,5,14,6,0,0,0,0,0,2,,0,0,0,,1,0,0,0,0,0,3,11,8,
2277,Morgan Higgins,1,3,0,0,0,0,0,0,0,,0,0,0,,0,0,0,0,0,0,0,3,1,
2278,Francisco Hazera,5,70,88,4,1,3,0,0,24,,0,0,0,,7,4,0,0,0,0,47,23,72,
2279,Chris Malackany,1,1,0,0,0,0,0,0,1,,0,0,0,,0,0,0,0,0,0,1,0,0,
2280,Jarnail Bajwa,22,448,632,51,36,15,8,-1,704,90.6,0,0,0,41.46,29,57,3,3,0,0,392,56,496,
2281,Thomas Rowe,6,88,68,1,1,0,3,-1,25,,0,0,0,,2,5,0,0,0,0,4,84,60,
2282,Mike Plunkett,10,38,0,15,13,2,1,-1,88,87.13,0,0,0,,0,13,0,4,0,0,17,21,0,
2283,Nicolas Dacey,5,53,0,2,0,2,0,-1,9,,0,0,0,,0,0,0,3,0,0,12,41,0,
2284,Jeremy Kanter,11,114,81,7,5,2,4,-1,52,,0,0,0,,0,12,0,0,0,1,43,71,69,
2285,Kelvin Huang,5,45,20,2,1,1,0,-1,6,,51,39,12,,0,2,0,1,0,0,2,43,48,
2286,Ryan Balch,11,201,167,8,6,2,6,-1,153,90.53,0,0,0,25.15,6,13,0,2,0,16,75,126,189,
2287,Eugene Lim,5,23,37,0,0,0,2,-1,11,,0,0,0,,0,2,0,1,0,3,4,19,31,
2288,Eric Huang,12,171,0,20,11,9,6,-1,233,91.73,0,0,0,,0,21,0,6,0,10,119,52,0,
2289,Soph Long,5,50,44,1,1,0,0,-1,23,,0,0,0,,0,2,1,0,0,0,9,41,50,
2290,Matthew Kissmann,11,235,314,14,8,6,2,-1,247,91.48,1241,1184,57,45.86,17,16,0,1,0,0,233,2,260,
2291,Mike Zaagman,6,17,0,4,2,2,0,-1,37,,0,0,0,,0,5,0,0,0,1,9,8,0,
2292,Flint,1,12,12,0,0,0,0,-1,4,,0,0,0,,0,1,0,0,0,0,1,11,9,
2293,Mac Rushing,4,50,30,0,0,0,1,-1,24,,0,0,0,,2,2,0,0,0,0,13,37,35,
2294,Desmond Staples,4,41,27,2,1,1,0,-1,10,,130,108,22,,0,2,0,1,0,0,0,41,46,
2295,AJ Humbert,1,17,12,0,0,0,0,-1,2,,0,0,0,,0,1,0,0,0,0,4,13,16,
2296,Adam Turner,3,38,36,2,2,0,1,-1,23,,0,0,0,,0,4,0,0,0,0,10,28,35,
2297,William Johnson,1,13,15,0,0,0,0,-1,13,,0,0,0,,1,1,0,0,0,0,10,3,10,
2298,Jordan Faries,1,12,2,0,0,0,0,-1,0,,0,0,0,,0,0,0,1,0,0,0,12,8,
2299,Tyler Hebert,7,88,60,1,0,1,1,-1,30,,263,181,82,,2,2,0,1,0,1,24,64,87,
2300,Kevin Ludwig,2,9,8,0,0,0,0,-1,5,,0,0,0,,1,1,0,0,0,0,0,9,9,
2301,Joe Simonelli,12,151,36,4,2,2,6,-1,86,,0,0,0,,1,9,0,2,0,0,33,118,41,Handler
2302,Dylan Smith,6,78,58,1,0,1,1,-1,32,,0,0,0,,1,3,0,0,0,0,11,67,56,
2303,Mitch Kulczak,5,83,84,3,1,2,2,-1,52,,0,0,0,,1,5,0,1,0,0,36,47,79,
2304,Judah Newman,20,326,306,16,9,7,5,-1,233,92.46,0,0,0,39.22,15,16,0,6,0,6,116,210,318,
2305,Gary Grant,5,63,49,4,3,1,1,-1,32,,0,0,0,,2,5,0,1,0,0,8,55,50,
2306,Jeffery Minowa,2,23,10,0,0,0,0,-1,3,,0,0,0,,0,1,0,0,0,7,1,22,19,
2307,Casey Bybee,7,40,0,1,0,1,1,-1,7,,0,0,0,,0,1,0,2,0,0,5,35,0,
2308,Basten de Jongh,13,293,278,15,7,8,5,-1,77,,0,0,0,24.1,10,16,0,5,0,123,139,154,256,Cutter
2309,Alex Hutton,2,21,15,0,0,0,0,-1,4,,0,0,0,,0,0,0,1,0,0,6,15,15,
2310,Stuart Hean,5,54,81,7,5,2,0,-1,47,,0,0,0,,6,6,0,2,0,0,44,10,64,Handler
2311,Brandon Kahler,7,58,32,1,0,1,0,-1,14,,0,0,0,,0,0,0,2,0,0,11,47,47,
2312,Todd Grace,27,265,17,39,29,10,17,-1,298,90.3,0,0,0,,1,47,1,10,0,3,65,200,15,
2313,Patrick Diviney,2,13,9,0,0,0,0,-1,0,,0,0,0,,0,1,0,0,0,2,1,12,10,Cutter
2314,Thomas Stanton,4,47,28,0,0,0,2,-1,3,,46,25,21,,0,3,0,0,0,1,2,45,51,
2315,Kenji Hood,10,220,278,21,10,11,9,-1,151,84.36,0,0,0,29.14,4,25,4,6,0,1,148,72,184,
2316,Ian Dietrich,6,82,45,1,1,0,2,-1,29,,252,97,155,,2,4,0,0,0,0,10,72,95,Cutter
2317,Andrew Wadaga,2,11,13,0,0,0,0,-1,2,,0,0,0,,0,1,0,0,0,0,5,6,7,
2318,Alec Norton,8,143,143,7,3,4,3,-1,24,,0,0,0,16.78,1,8,0,3,0,3,46,97,136,
2319,Josh Findley,6,91,93,4,1,3,0,-1,102,95.33,0,0,0,,1,4,0,1,0,0,53,38,82,
2320,Jason Schafer,11,254,307,33,28,5,2,-1,282,88.4,0,0,0,48.53,8,34,2,2,0,21,196,58,229,
2321,Qxhna Titcomb,2,24,32,2,2,0,0,-1,17,,0,0,0,,1,3,0,0,0,0,20,4,23,
2322,Andrew Seibert,1,10,8,0,0,0,1,-1,0,,10,0,10,,0,1,0,1,0,0,0,10,10,Cutter
2323,Kyle Hunter,2,23,11,1,1,0,0,-1,7,,86,67,19,,1,2,0,0,0,14,0,23,27,
2324,Jon Gibson,6,101,99,6,4,2,0,-1,38,,0,0,0,,2,6,0,1,0,1,51,50,114,
2325,Vincent Houle,1,8,4,0,0,0,0,-1,1,,0,0,0,,0,1,0,0,0,1,2,6,5,
2326,Dennis Maclaine,3,22,7,0,0,0,0,-1,1,,0,0,0,,0,1,0,0,0,3,0,22,15,
2327,Jacob Larsen,4,50,40,2,1,1,0,-1,74,,0,0,0,,5,3,1,0,0,0,23,27,52,
2328,Cameron Kennedy,2,19,8,0,0,0,0,-1,0,,9,0,9,,0,1,0,0,0,1,0,19,22,
2329,Jay Talerman,1,2,2,0,0,0,0,-1,1,,-4,-5,1,,0,0,0,1,0,0,1,1,0,
2330,Clayton Partlow,2,16,6,0,0,0,0,-1,2,,52,-1,53,,0,1,0,0,0,0,3,13,10,
2331,Mike Merwin,2,18,13,0,0,0,0,-1,6,,0,0,0,,0,1,0,0,0,0,4,14,12,
2332,Dan Jakob,2,29,24,1,1,0,0,-1,11,,0,0,0,,2,1,0,1,0,0,12,17,20,
2333,Freddy Perlman,10,117,0,14,9,5,6,-1,90,83.33,0,0,0,,0,18,0,3,0,28,40,77,0,
2334,Eric Williams,10,149,110,1,1,0,3,-1,57,,0,0,0,26.36,4,5,0,0,0,0,29,120,119,
2335,Kuochuan Ponzio,2,30,4,0,0,0,0,-1,4,,33,10,23,,0,1,0,0,0,0,2,28,27,
2336,Evan Caldwell,4,39,30,1,0,1,2,-1,8,,0,0,0,,0,4,0,0,0,0,7,32,27,
2337,Zach Grappone,1,4,1,0,0,0,0,-1,0,,0,0,0,,0,1,0,0,0,0,0,4,2,Handler
2338,Sam Tagle,4,40,40,3,1,2,1,-1,15,,323,166,157,,3,5,0,0,0,0,14,26,50,
2339,Charles Yu,4,15,0,0,0,0,2,-1,14,,0,0,0,,0,3,0,0,0,1,2,13,0,
2340,Craig Froats,9,83,93,7,7,0,2,-1,29,,0,0,0,,1,10,0,0,0,4,12,71,83,
2341,Joel Morton,2,33,40,2,1,1,1,-1,9,,0,0,0,,1,1,0,3,0,0,27,6,26,
2342,Will Hannon,10,192,271,13,8,5,3,-1,201,91.78,0,0,0,46.13,13,14,0,3,0,0,185,7,184,
2343,Ariel Klevecz,6,78,62,0,0,0,0,-1,11,,0,0,0,,0,0,0,1,0,0,12,66,67,
2344,Tony Heath,13,207,172,8,4,4,4,-1,66,,0,0,0,26.16,4,10,1,3,0,0,39,168,186,
2345,Hector Ordonez,4,44,43,1,1,0,1,-1,14,,284,35,249,,3,3,0,0,0,0,21,23,56,
2346,Mike Campanella,17,181,158,6,3,3,4,-1,30,,23,-1,24,27.22,4,9,0,2,0,0,19,162,190,Cutter
2347,Michael Van Ness,4,49,32,1,1,0,2,-1,17,,0,0,0,,2,4,0,0,0,0,2,47,36,
2348,Robert Dennis,4,26,24,0,0,0,0,-1,9,,0,0,0,,1,1,0,0,0,0,4,22,29,
2349,Jim Boley,9,129,107,4,2,2,2,-1,41,,0,0,0,35.51,4,6,0,1,0,1,23,106,112,
2350,Raleigh Van Epps,1,8,6,0,0,0,0,-1,2,,0,0,0,,0,0,0,1,0,0,0,8,8,
2351,Tim Predmore,4,11,7,0,0,0,0,-1,1,,25,5,20,,0,0,0,1,0,0,0,11,9,Defender
2352,Brian McLaughlin,8,89,86,3,3,0,3,-1,51,,0,0,0,,7,7,1,0,0,22,11,78,80,
2353,Lauchlan Robertson,5,86,72,4,3,1,2,-1,41,,0,0,0,,1,7,1,0,0,35,19,67,75,
2354,Ryan Lee,3,40,28,1,1,0,1,-1,12,,106,75,31,,1,3,0,0,0,0,10,30,37,
2355,Ben Scharfstein,8,106,81,4,3,1,3,-1,65,,0,0,0,,3,8,0,0,0,6,18,88,100,
2356,Daniel Wong,6,63,30,0,0,0,2,-1,6,,92,11,81,,0,1,0,2,0,0,0,63,77,
2357,Dustin Hughes,9,85,42,0,0,0,1,-1,19,,0,0,0,,0,1,0,1,0,29,13,72,74,
2358,Tyler Conger,27,737,970,62,54,8,13,-1,1114,93.22,0,0,0,43.4,77,66,2,10,0,11,634,103,703,
2359,John Stavinga,10,157,0,11,8,3,8,-2,211,92.54,0,0,0,,0,17,0,4,0,1,94,63,0,
2360,Daniel Hunt,46,779,730,47,20,27,24,-2,306,81.82,0,0,0,21.64,14,60,0,13,0,24,277,502,672,
2361,Otis Williams,2,16,15,1,1,0,1,-2,14,,184,109,75,,0,3,0,1,0,0,7,9,20,
2362,Dan Turcotte,5,59,46,4,3,1,0,-2,34,,0,0,0,,9,5,0,1,0,1,3,56,44,
2363,Elijah Karoly,3,46,49,1,1,0,1,-2,30,,0,0,0,,3,2,0,2,0,3,32,14,38,
2364,Peter Kalmakis,17,155,149,7,7,0,3,-2,104,89.66,0,0,0,37.58,7,11,0,1,0,12,57,98,156,
2365,Chad McCausland,6,48,31,0,0,0,0,-2,8,,0,0,0,,1,0,0,2,0,0,4,44,53,
2366,Alex Liu,10,92,56,3,3,0,1,-2,26,,0,0,0,,1,5,0,1,0,0,3,89,70,
2367,John David Liboon,2,39,38,1,1,0,0,-2,38,,0,0,0,,3,3,0,0,0,8,19,20,37,
2368,Garrett Wilson,10,154,117,3,2,1,1,-2,39,,0,0,0,29.91,2,5,0,1,0,1,28,126,143,
2369,Shashank Alladi,11,151,102,7,7,0,3,-2,67,,0,0,0,43.14,10,11,0,1,0,7,13,138,133,Handler
2370,Steve Panasuik,6,8,0,3,1,2,2,-2,38,,0,0,0,,0,6,0,1,0,0,3,5,0,
2371,Dominic Conti,4,5,0,0,0,0,2,-2,24,,0,0,0,,0,4,0,0,0,0,1,4,0,
2372,David Woods,41,525,473,20,12,8,10,-2,440,92.05,-10,2,-12,35.31,21,26,1,6,0,1,135,390,524,Handler
2373,Gregory Arenson,2,27,31,1,1,0,0,-2,23,,0,0,0,,0,2,0,1,0,9,11,16,30,
2374,Will Drumright,10,114,89,4,3,1,1,-2,42,,0,0,0,,3,7,0,0,0,0,18,96,98,
2375,James O,1,6,17,0,0,0,1,-2,1,,0,0,0,,1,3,0,0,0,0,2,4,10,
2376,Graham Whittington,4,59,72,5,2,3,0,-2,49,,0,0,0,,1,7,0,0,0,1,47,12,58,
2377,Matthew Perdulla,7,80,46,3,2,1,1,-2,32,,0,0,0,,0,4,0,2,0,0,19,61,54,
2378,Jaime Benites,2,23,30,0,0,0,0,-2,7,,0,0,0,,0,2,0,0,0,0,5,18,27,
2379,Jup Patel,10,149,91,3,2,1,2,-2,32,,338,18,320,,2,4,0,3,0,0,35,114,142,
2380,Jason Hustad,9,107,66,9,6,3,1,-2,47,,770,390,380,,5,12,1,0,0,11,3,104,130,
2381,Andrew Thompson,7,71,31,0,0,0,0,-2,3,,20,7,13,,0,2,0,0,0,0,0,71,68,
2382,Sam Cocchia,4,38,0,3,2,1,0,-2,14,,0,0,0,,0,4,0,1,0,6,22,16,0,
2383,Simon-Philippe Lebel,3,34,35,2,2,0,0,-2,31,,0,0,0,,0,3,0,1,0,0,7,27,34,
2384,Jon Rosen,4,32,20,0,0,0,0,-2,9,,0,0,0,,0,2,0,0,0,0,3,29,18,
2385,Ian Sweeney,6,95,71,2,2,0,5,-2,29,,0,0,0,,0,7,0,2,0,14,8,87,91,
2386,David Zurbuchen,5,20,0,1,0,1,0,-2,7,,0,0,0,,0,1,0,2,0,0,13,7,0,
2387,Joe Sullivan,4,44,70,1,0,1,4,-2,59,,0,0,0,,2,4,0,3,0,0,42,2,46,
2388,Ross Markle,6,52,41,1,1,0,1,-2,23,,0,0,0,,1,4,0,0,0,1,9,43,46,
2389,Jason DeMaso,11,70,0,25,22,3,9,-2,248,95.75,0,0,0,,0,34,0,2,0,0,40,30,0,
2390,Zach Kieffer,2,51,57,5,4,1,0,-2,30,,0,0,0,,4,5,0,2,0,0,42,9,34,
2391,Doug Stenclik,1,23,24,1,1,0,1,-2,12,,0,0,0,,0,4,0,0,0,3,9,14,23,
2392,Michael Wormley,1,7,10,1,0,1,1,-2,6,,0,0,0,,0,2,0,2,0,0,0,7,7,
2393,Devin Foster,10,130,158,4,2,2,7,-2,62,,0,0,0,20.25,4,9,0,4,0,8,61,69,139,
2394,Ryan Yergin,13,241,284,10,5,5,7,-2,95,85.59,0,0,0,27.11,5,12,0,7,0,0,141,100,227,Cutter
2395,Tom Bertrand,1,8,13,0,0,0,0,-2,4,,0,0,0,,0,2,0,0,0,0,5,3,12,
2396,Ian Dipace,10,90,13,5,3,2,1,-2,21,,0,0,0,,1,4,0,4,0,2,17,73,12,
2397,Keivaun Waugh,7,146,175,8,6,2,1,-2,218,94.78,0,0,0,45.14,7,9,0,2,0,8,107,39,156,
2398,Gina Schumacher,4,60,47,2,0,2,0,-2,14,,0,0,0,,0,0,0,4,0,0,25,35,39,
2399,Danny Hunt,16,260,234,16,12,4,7,-2,203,88.65,0,0,0,46.58,17,22,1,3,0,10,156,104,182,
2400,Zach Johnston,4,22,0,2,1,1,0,-2,15,,0,0,0,,0,4,1,0,0,0,6,16,0,
2401,David Berendes,7,69,55,1,0,1,1,-2,6,,0,0,0,,0,2,0,2,0,0,6,63,61,
2402,Jeff Brauning,4,53,52,1,1,0,2,-2,42,,0,0,0,,4,5,1,0,0,0,14,39,51,
2403,Dan Smeltzer,7,62,51,4,1,3,0,-2,42,,0,0,0,,3,5,0,1,0,10,10,52,47,
2404,Jon Meade,7,133,172,5,0,5,2,-3,136,93.79,0,0,0,46.51,5,9,0,1,0,0,120,13,126,
2405,Nathan Warden,9,93,52,1,1,0,0,-3,14,,0,0,0,,1,2,0,2,0,0,9,84,74,
2406,Jesse Shofner,12,174,211,6,2,4,0,-3,83,,0,0,0,36.97,4,7,0,2,0,0,143,31,144,
2407,Andrew Tang,13,175,216,10,10,0,5,-3,120,87.59,0,0,0,27.31,7,15,0,3,0,1,74,101,175,
2408,Andrell Caldwell,1,8,9,0,0,0,0,-3,10,,0,0,0,,0,2,0,1,0,0,3,5,6,
2409,Elliot Lee,15,184,237,4,3,1,1,-3,265,97.07,0,0,0,57.38,19,7,2,1,0,0,172,12,170,Handler
2410,Kamil Skwarek,16,150,166,22,14,8,5,-3,219,88.66,0,0,0,42.17,12,27,2,3,0,2,125,25,116,
2411,Jerome Boucher,13,251,287,21,17,4,6,-3,383,92.07,0,0,0,40.07,28,29,1,1,0,15,172,79,237,
2412,Bruno-Pier Demers,6,69,83,6,6,0,1,-3,79,,0,0,0,,6,10,0,0,0,1,56,13,64,
2413,Isaac Saul,20,448,611,57,51,6,6,-3,740,91.02,0,0,0,47.95,60,63,1,3,0,1,397,51,416,
2414,Satoru Ishii,5,41,25,0,0,0,0,-3,11,,102,108,-6,,0,1,0,2,0,0,5,36,47,
2415,David Zickus,4,114,135,10,5,5,2,-3,88,85.44,0,0,0,9.63,4,14,0,1,0,0,86,28,118,
2416,Michael Dagher-Margosia,5,99,137,5,4,1,3,-3,152,93.25,0,0,0,36.5,10,6,0,5,0,0,78,21,121,
2417,Sam Schurer,20,309,297,25,23,2,13,-3,228,83.82,0,0,0,35.35,19,40,0,1,0,165,66,243,279,
2418,Alex Lowy,8,96,115,4,2,2,2,-3,56,,0,0,0,22.61,1,8,0,1,0,6,64,32,86,
2419,J Patell,1,21,15,0,0,0,0,-3,2,,0,0,0,,0,3,0,0,0,0,8,13,16,
2420,Ian Collins,14,256,224,10,7,3,13,-3,159,87.36,0,0,0,26.79,3,23,0,3,0,64,80,176,224,
2421,Jordan Ciccarone,4,47,49,1,1,0,0,-3,28,,0,0,0,,1,3,0,1,0,2,9,38,54,Handler
2422,Jacob Dummeldinger,2,37,43,1,0,1,0,-3,14,,321,42,279,,3,1,0,3,0,0,28,9,40,
2423,Eric Converse,9,154,161,6,4,2,5,-3,114,88.37,0,0,0,40.99,4,13,0,1,0,8,108,46,120,
2424,Jason McGeeney,4,5,0,0,0,0,1,-3,28,,0,0,0,,0,3,0,1,0,0,1,4,0,
2425,Lou Abramowski,7,51,45,1,1,0,1,-3,21,,0,0,0,,4,5,1,0,0,2,19,32,39,
2426,Noah Fisher,6,84,131,8,8,0,8,-3,221,89.47,0,0,0,26.72,9,18,0,1,0,8,63,21,109,Handler
2427,David Witte,4,51,44,0,0,0,0,-3,23,,229,132,97,,4,2,1,1,0,0,20,31,49,
2428,Patrick McMullen,34,567,484,21,12,9,6,-3,399,91.3,573,463,110,36.78,42,26,1,4,0,1,140,427,598,
2429,Dan Oettinger,12,203,197,13,11,2,5,-3,193,89.77,0,0,0,34.52,10,19,0,2,0,96,86,117,197,
2430,Austin Lillis,14,175,140,6,2,4,2,-3,86,85.15,321,239,82,29.29,5,10,0,1,0,12,50,125,195,Handler
2431,Colin McCartney,14,262,301,16,8,8,6,-3,298,91.13,0,0,0,34.55,15,25,0,0,0,1,151,111,259,
2432,Alex Hill,11,190,167,13,9,4,1,-3,154,86.03,0,0,0,33.53,11,16,0,1,0,30,80,110,167,
2433,Austin Gaines,5,52,29,1,0,1,1,-3,17,,174,142,32,,1,4,1,1,0,22,3,49,54,
2434,James Baker Jr,2,38,21,2,1,1,0,-3,16,,0,0,0,,0,5,0,0,0,7,5,33,21,
2435,Souichi Terada,9,82,63,1,0,1,2,-3,12,,0,0,0,,0,2,0,4,0,0,40,42,62,
2436,Josh Tsung,6,65,40,0,0,0,0,-3,8,,0,0,0,,4,3,0,0,0,0,2,63,48,
2437,Justin Winn,10,190,162,13,7,6,3,-3,128,85.91,1287,801,486,29.63,4,18,0,1,0,10,83,107,200,
2438,Chris Cogswell,4,62,35,1,1,0,0,-3,11,,0,0,0,,1,3,0,1,0,0,2,60,41,
2439,Joey Ricks,4,113,188,7,4,3,3,-3,216,91.53,0,0,0,25.0,8,12,0,1,0,0,100,13,129,
2440,Craig Stewart,5,58,60,1,1,0,0,-3,32,,0,0,0,,1,4,0,0,0,0,28,30,54,
2441,Aaron Bacon,6,95,95,2,2,0,3,-3,26,,0,0,0,,3,7,0,1,0,0,28,67,94,
2442,Dennis M,5,31,45,2,0,2,0,-3,30,,0,0,0,,2,4,1,1,0,7,12,19,38,
2443,Mark Mendelevitz,4,25,15,0,0,0,0,-3,10,,39,38,1,,0,3,0,0,0,0,1,24,29,
2444,Matt Carter,8,161,220,20,11,9,7,-4,175,82.16,0,0,0,29.55,10,29,0,2,0,4,121,40,169,
2445,Ky Lewis,21,317,316,27,23,4,6,-4,295,89.12,0,0,0,39.87,10,32,0,5,0,4,118,199,310,
2446,Jimmy Budnik,10,232,284,16,13,3,6,-4,299,90.88,0,0,0,25.0,11,19,0,7,0,8,157,75,207,
2447,Mike Coughlin,12,179,0,6,4,2,3,-4,188,94.0,0,0,0,,0,12,0,1,0,0,135,44,0,
2448,Jon Swartling,8,72,0,2,0,2,1,-4,74,,0,0,0,,0,6,1,1,0,0,46,26,0,
2449,Owen Williams,9,87,0,4,3,1,2,-4,59,,0,0,0,,0,9,0,1,0,13,31,56,0,
2450,Aaron Bell,5,50,0,12,8,4,3,-4,69,,0,0,0,,0,16,0,3,0,0,37,13,0,
2451,Jason Thompson,7,73,0,0,0,0,2,-4,29,,0,0,0,,0,6,0,0,0,4,48,25,0,
2452,Kyle Golrick,12,162,0,10,6,4,3,-4,111,89.52,0,0,0,,0,13,0,4,0,0,106,56,0,
2453,Joe Tylutki,6,62,43,1,1,0,0,-4,14,,0,0,0,,3,5,0,0,0,0,4,58,59,
2454,David Baer,19,176,92,30,21,9,11,-4,299,89.52,0,0,0,,4,33,0,12,0,44,55,121,113,Handler
2455,Jake Reinhardt,18,277,201,7,4,3,13,-4,93,81.58,231,133,98,32.34,5,20,0,4,0,160,36,241,262,
2456,Will Sloan,2,29,0,1,1,0,0,-4,57,,0,0,0,,0,4,0,1,0,0,0,29,0,
2457,Steven Benaloh,9,124,126,8,5,3,1,-4,25,,0,0,0,40.48,2,13,0,0,0,3,52,72,114,
2458,Cole Wallin,5,102,112,8,5,3,1,-4,92,86.79,0,0,0,42.86,10,11,1,2,0,7,67,35,107,
2459,Stephen Grondin,5,58,26,0,0,0,0,-4,26,,291,211,80,,1,4,0,0,0,3,6,52,48,
2460,Carlos Vargas,19,281,298,19,13,6,3,-4,216,88.89,0,0,0,41.95,14,22,2,4,0,10,135,146,261,
2461,Kirk Kuespert,5,66,66,0,0,0,0,-4,8,,0,0,0,,0,1,0,3,0,0,38,28,61,
2462,Kevin Venose,25,406,246,49,33,16,24,-4,388,85.27,0,0,0,30.89,8,66,0,11,0,4,174,232,244,
2463,Alexander Isik,12,112,126,5,2,3,1,-4,81,,0,0,0,52.38,6,9,0,1,0,0,82,30,99,Handler
2464,Kenny Frisch,7,147,198,16,14,2,4,-4,206,88.79,0,0,0,30.3,4,22,0,2,0,2,138,9,129,
2465,Matthew Heffernan,2,54,63,1,0,1,0,-4,59,,0,0,0,,5,5,0,0,0,0,46,8,45,
2466,Robert Lewis,36,519,453,35,23,12,5,-4,352,87.56,264,316,-52,37.53,24,40,0,4,0,102,153,366,538,
2467,C Wood,7,104,91,4,3,1,3,-4,92,88.46,0,0,0,,8,10,0,1,0,25,23,81,102,Handler
2468,Jack Slevin,6,108,117,6,3,3,0,-4,119,92.97,0,0,0,44.44,6,9,0,1,0,1,61,47,97,
2469,Brandon Lamberty,7,123,93,8,6,2,2,-5,94,86.24,31,26,5,,5,14,0,1,0,18,25,98,109,Handler
2470,Chris Kosednar,11,199,243,17,11,6,5,-5,258,91.49,0,0,0,40.33,27,21,0,6,0,18,105,94,203,
2471,Nick BIssonnette,13,136,103,3,1,2,0,-5,21,,0,0,0,22.33,2,7,0,1,0,0,27,109,131,
2472,Victor Wu,7,121,112,1,1,0,4,-5,85,,0,0,0,23.21,8,8,0,2,0,4,28,93,115,
2473,Saul H,3,53,59,3,0,3,1,-5,47,,0,0,0,,4,8,0,1,0,0,29,24,43,
2474,Riggs Mohler,6,81,103,2,1,1,2,-5,45,,0,0,0,20.39,2,4,0,5,0,4,52,29,82,
2475,Kevin Chiang,18,130,0,23,15,8,9,-5,197,86.4,0,0,0,,0,31,0,6,0,3,33,97,0,
2476,Caleb Ferguson,8,110,70,4,2,2,0,-5,43,,0,0,0,,1,7,0,2,0,61,11,99,81,
2477,Charlie Schuweiler,10,162,181,9,9,0,7,-5,196,88.69,0,0,0,39.23,9,21,0,0,0,30,81,81,149,
2478,Chris Barrett,4,67,52,0,0,0,1,-5,48,,0,0,0,,3,5,0,1,0,0,12,55,65,
2479,Andrew Misthos,7,63,0,7,7,0,6,-5,100,87.72,0,0,0,,0,14,0,4,0,3,43,20,0,
2480,Dante Lopez-Escarez,2,21,21,1,0,1,1,-5,9,,130,43,87,,0,7,0,0,0,3,6,15,25,Handler
2481,Charlie Edmiston,4,5,0,1,1,0,0,-5,56,,0,0,0,,0,6,0,0,0,0,1,4,0,
2482,Dutch Kirkman,14,305,455,19,15,4,12,-5,373,89.88,0,0,0,28.57,7,30,0,6,0,0,202,103,342,
2483,Jacob Saunders,27,474,589,14,10,4,4,-5,633,96.49,0,0,0,47.71,45,18,0,5,0,0,356,118,498,
2484,Mitch Wheeler,7,82,119,8,6,2,0,-5,119,86.86,0,0,0,26.89,6,13,0,0,0,0,76,6,83,
2485,Ken Noh,2,17,15,0,0,0,0,-5,20,,140,122,18,,1,4,0,1,0,0,9,8,17,
2486,Seth Collins,5,83,88,6,3,3,3,-6,53,,0,0,0,,8,14,0,1,0,6,40,43,75,
2487,Ryo Kawaoka,13,273,328,13,9,4,8,-6,216,86.4,0,0,0,40.24,13,26,0,1,0,15,125,148,269,
2488,Patrick Stegemoeller,14,177,153,4,2,2,0,-6,121,88.32,0,0,0,28.1,3,7,0,3,0,0,73,104,139,
2489,Sam Carletta,14,246,210,12,8,4,7,-6,126,83.44,0,0,0,28.57,5,20,0,5,0,59,55,191,236,
2490,Kristian Johnson,24,481,397,32,26,6,3,-6,377,88.92,399,325,74,44.84,25,41,0,0,0,260,152,329,468,Handler
2491,Jonathan Lee,6,50,39,0,0,0,0,-6,29,,0,0,0,,0,6,0,0,0,2,20,30,44,
2492,Laurent Faye,12,227,303,13,7,6,1,-6,393,94.7,0,0,0,50.17,23,19,0,1,0,0,204,23,258,
2493,Chris Schulze,13,155,159,4,1,3,0,-6,41,,0,0,0,25.16,3,10,0,0,0,44,52,103,166,
2494,Harry Mcnamara,10,150,109,4,1,3,1,-6,81,,655,437,218,38.53,5,7,0,4,0,3,45,105,158,
2495,Craig Anderson,11,268,268,8,4,4,2,-7,269,93.4,0,0,0,43.28,17,14,0,3,0,1,167,101,263,
2496,Drew Chapman,2,48,56,0,0,0,0,-7,33,,0,0,0,,2,7,0,0,0,1,38,10,46,
2497,Alex Bullock,29,343,226,17,15,2,7,-7,182,83.49,0,0,0,32.3,9,26,0,5,0,131,34,309,289,
2498,Austin Bartenstein,28,470,418,30,25,5,8,-7,355,88.53,0,0,0,41.39,28,42,3,3,0,175,143,327,433,
2499,Jason Chow,8,132,209,2,1,1,1,-7,141,92.76,0,0,0,37.8,5,9,3,1,0,0,119,13,145,
2500,Adlai Felser,12,261,294,16,14,2,6,-7,235,89.02,0,0,0,30.95,11,26,0,3,0,1,74,187,270,
2501,Craig Bunce,4,5,0,1,0,1,1,-7,70,,0,0,0,,0,9,0,0,0,0,1,4,0,
2502,Philip Hornberger,9,221,220,14,12,2,4,-7,207,87.71,0,0,0,29.55,9,21,2,4,0,22,86,135,167,
2503,Ian Andre-Knudsen,4,72,105,7,5,2,1,-7,164,90.11,0,0,0,37.14,8,13,0,2,0,0,65,7,81,
2504,Bryan Bush,11,223,307,7,3,4,2,-7,145,91.19,0,0,0,30.29,10,13,0,3,0,0,209,14,211,
2505,Kyle Welch,14,265,204,9,6,3,3,-8,94,83.19,0,0,0,24.02,6,14,0,6,0,2,64,201,233,
2506,Pat Cashman,14,118,109,2,2,0,1,-8,89,88.12,0,0,0,36.7,5,9,0,2,0,29,34,84,104,Handler
2507,John Clyde,7,106,97,5,4,1,3,-8,71,,451,558,-107,,4,16,0,0,0,38,44,62,122,
2508,Stephanie Lim,8,136,179,4,0,4,1,-8,149,91.98,0,0,0,49.72,11,11,0,2,0,0,132,4,118,
2509,Zach Kaylor,12,174,138,1,1,0,2,-8,83,,0,0,0,25.36,6,9,0,2,0,0,29,145,140,
2510,Matthew King,14,301,344,23,21,2,16,-8,322,85.19,0,0,0,32.27,31,45,0,2,0,7,72,229,313,
2511,Takashi Sato,14,202,208,8,5,3,4,-8,119,84.4,0,0,0,25.96,6,20,0,0,0,1,116,86,163,
2512,Cody Fox,14,282,317,18,10,8,4,-8,253,89.08,0,0,0,29.65,11,26,2,4,0,3,158,124,260,
2513,Dafeng Chen,29,393,341,15,9,6,7,-8,170,85.0,0,0,0,19.06,6,24,0,6,0,15,128,265,340,
2514,Joe Forbes,7,114,150,4,4,0,0,-9,165,92.18,0,0,0,42.0,9,13,0,0,0,0,103,11,124,
2515,Jon Stone,37,751,957,49,34,15,16,-9,1063,92.92,0,0,0,40.02,60,64,0,10,0,11,592,159,797,
2516,Tom Duellman,6,117,132,2,2,0,6,-9,90,82.57,0,0,0,18.18,6,15,0,2,0,0,52,65,125,
2517,Evan Parizot,6,115,146,9,6,3,4,-9,73,,0,0,0,25.34,9,20,0,2,0,4,73,42,116,Handler
2518,Sonny Frazee,5,62,51,2,2,0,0,-10,23,,0,0,0,,2,10,0,2,0,1,19,43,50,
2519,Russ Barr,11,283,384,17,9,8,7,-10,244,86.83,0,0,0,27.08,7,26,0,8,0,5,224,59,256,
2520,Thomas Lassetter,16,301,330,21,14,7,2,-10,361,90.7,0,0,0,49.39,13,31,0,2,0,4,220,81,303,
2521,Alex Smith,11,127,153,4,3,1,0,-10,115,87.79,0,0,0,26.8,5,14,0,0,0,6,93,34,126,
2522,Travis Compo,9,180,187,8,6,2,7,-11,144,84.71,0,0,0,27.81,13,23,1,3,0,13,70,110,164,Handler
2523,Jeff Kiel,13,280,341,15,10,5,6,-11,367,91.07,0,0,0,32.26,27,28,0,4,0,11,167,113,326,
2524,Christopher Auman,17,199,161,5,3,2,1,-11,70,,0,0,0,14.29,7,15,0,2,0,0,72,127,154,
2525,Wilson Gardner,8,166,229,13,10,3,2,-11,220,90.16,0,0,0,32.75,12,19,0,7,0,0,149,17,152,
2526,Alex Hunt,13,181,165,7,5,2,1,-11,56,,0,0,0,16.36,2,14,0,5,0,25,82,99,147,
2527,Michael Friis-Jensen,10,42,0,15,15,0,2,-11,157,88.2,0,0,0,,0,21,0,7,0,0,24,18,0,
2528,Nicholas Calucci,9,165,120,2,0,2,1,-11,48,,0,0,0,17.5,2,11,0,3,0,0,49,116,123,Handler
2529,John Henkel,10,152,153,5,2,3,4,-11,79,,0,0,0,17.65,1,14,1,6,0,69,49,103,157,
2530,Matthew Gallin,32,480,412,51,42,9,30,-11,601,86.1,0,0,0,28.64,17,85,2,7,0,246,179,301,397,
2531,Cole Osborn,7,137,138,11,9,2,5,-12,85,73.91,0,0,0,26.09,8,27,0,1,0,19,47,90,127,
2532,Stephen Glauser,5,15,0,3,2,1,5,-12,83,,0,0,0,,0,18,0,2,0,0,3,12,0,
2533,Mischa Horowitz,11,92,17,30,26,4,2,-12,232,85.93,0,0,0,,1,37,0,7,0,0,46,46,12,
2534,Chris Balch,8,98,120,2,2,0,1,-13,110,90.16,0,0,0,22.5,2,12,1,4,0,0,72,26,76,
2535,Andrew Miller,4,6,0,2,1,1,1,-13,96,87.27,0,0,0,,0,14,0,2,0,0,2,4,0,
2536,Joe DiPaula,15,342,0,24,10,14,6,-14,374,92.12,0,0,0,,0,30,2,14,0,4,236,106,0,
2537,Craig H,3,52,78,3,2,1,2,-14,81,81.0,0,0,0,,2,16,0,3,0,0,51,1,39,
2538,Michael Miller,12,77,0,38,30,8,7,-14,420,89.36,0,0,0,,0,50,0,9,0,0,38,39,0,
2539,Sawyer Fil,10,135,97,0,0,0,4,-14,46,,535,188,347,,2,17,0,1,0,1,28,107,138,
2540,Wasdi Grimaldo,29,525,595,25,22,3,23,-14,457,86.55,0,0,0,29.24,31,57,0,5,0,7,290,235,490,
2541,Charles Patten,16,208,53,8,7,1,4,-14,211,90.17,0,0,0,,1,23,0,3,0,0,104,104,55,
2542,Evan Hughes,19,373,298,39,26,13,2,-14,375,87.62,0,0,0,26.51,9,45,0,10,0,49,199,174,249,
2543,Trent Kuhl,12,194,209,11,11,0,2,-15,199,88.84,0,0,0,36.36,14,23,1,5,0,23,74,120,202,
2544,Cory Green,9,168,237,18,13,5,0,-15,209,87.82,0,0,0,27.0,8,28,0,5,0,0,113,55,172,
2545,Karl Fauerbach,18,282,323,17,14,3,7,-16,358,89.72,0,0,0,27.55,8,35,0,5,0,0,177,105,302,
2546,Joe Friedman,16,126,0,3,2,1,3,-16,339,96.58,0,0,0,,0,12,0,10,0,0,106,20,0,
2547,Patrick Krantz,34,666,709,40,24,16,18,-16,444,83.46,0,0,0,23.84,19,66,0,8,0,304,287,379,613,
2548,Dean Culver,12,93,0,21,19,2,4,-19,240,94.86,0,0,0,,0,35,0,9,0,22,25,68,0,
2549,Brendan Schwalm,22,287,258,14,8,6,5,-21,307,89.5,0,0,0,25.19,13,33,0,7,0,9,206,81,197,
2550,Porter Bishop,13,109,0,13,13,0,5,-23,184,83.64,0,0,0,,0,36,0,5,0,2,60,49,0,
2551,Brian Ventura,25,507,711,23,13,10,4,-25,792,93.95,0,0,0,48.95,49,45,0,7,0,0,468,39,509,
2552,David Brooks,11,286,360,20,15,5,6,-28,343,85.32,0,0,0,25.0,7,48,0,6,0,38,192,94,264,
2553,Dan Schuster,8,158,259,7,5,2,1,-29,202,84.87,0,0,0,32.05,13,35,0,2,0,0,152,6,164,
2554,Brian Kibler,24,522,709,23,18,5,5,-30,856,92.14,0,0,0,33.43,36,51,0,7,0,1,431,91,561,
2555,Danny Young,16,326,435,32,29,3,9,-31,443,83.11,0,0,0,29.66,23,71,0,1,0,9,185,141,336,
2556,David Innis,23,485,578,32,25,7,8,-33,833,91.84,2429,2302,127,36.85,39,65,0,8,0,3,403,82,571,
2557,Josh Lyder,24,490,595,23,20,3,10,-35,565,88.7,0,0,0,24.2,17,61,2,7,0,21,277,213,494,Handler
